GEOFIPS,Geo_QName,Geo_NAME,Occupied Housing Units,Owner Occupied,Renter Occupied,Median Value
06037101110,"Census Tract 1011.10, Los Angeles County, California",Census Tract 1011.10,1494,850,644,549500
06037101122,"Census Tract 1011.22, Los Angeles County, California",Census Tract 1011.22,1372,1028,344,707200
6037101220,"Census Tract 1012.20, Los Angeles County, California",Census Tract 1012.20,1357,595,762,582300
06037101221,"Census Tract 1012.21, Los Angeles County, California",Census Tract 1012.21,1450,310,1140,482300
06037101222,"Census Tract 1012.22, Los Angeles County, California",Census Tract 1012.22,935,119,816,421600
06037101300,"Census Tract 1013, Los Angeles County, California",Census Tract 1013,1420,1178,242,680700
06037101400,"Census Tract 1014, Los Angeles County, California",Census Tract 1014,1304,917,387,589200
06037102103,"Census Tract 1021.03, Los Angeles County, California",Census Tract 1021.03,669,419,250,775200
06037102104,"Census Tract 1021.04, Los Angeles County, California",Census Tract 1021.04,1310,1021,289,618200
06037102105,"Census Tract 1021.05, Los Angeles County, California",Census Tract 1021.05,554,303,251,553400
06037102107,"Census Tract 1021.07, Los Angeles County, California",Census Tract 1021.07,1204,944,260,710600
06037103101,"Census Tract 1031.01, Los Angeles County, California",Census Tract 1031.01,915,805,110,645000
06037103102,"Census Tract 1031.02, Los Angeles County, California",Census Tract 1031.02,1651,1221,430,538400
06037103201,"Census Tract 1032.01, Los Angeles County, California",Census Tract 1032.01,1530,647,883,569800
06037103202,"Census Tract 1032.02, Los Angeles County, California",Census Tract 1032.02,660,641,19,738300
06037103300,"Census Tract 1033, Los Angeles County, California",Census Tract 1033,1203,1161,42,825500
06037103401,"Census Tract 1034.01, Los Angeles County, California",Census Tract 1034.01,988,850,138,629700
06037103402,"Census Tract 1034.02, Los Angeles County, California",Census Tract 1034.02,1372,1068,304,626100
06037104103,"Census Tract 1041.03, Los Angeles County, California",Census Tract 1041.03,866,693,173,556000
06037104105,"Census Tract 1041.05, Los Angeles County, California",Census Tract 1041.05,1526,764,762,399500
06037104108,"Census Tract 1041.08, Los Angeles County, California",Census Tract 1041.08,1288,559,729,448300
06037104124,"Census Tract 1041.24, Los Angeles County, California",Census Tract 1041.24,1281,995,286,531700
06037104201,"Census Tract 1042.01, Los Angeles County, California",Census Tract 1042.01,916,728,188,491400
06037104203,"Census Tract 1042.03, Los Angeles County, California",Census Tract 1042.03,1125,659,466,446300
06037104204,"Census Tract 1042.04, Los Angeles County, California",Census Tract 1042.04,731,473,258,421600
06037104310,"Census Tract 1043.10, Los Angeles County, California",Census Tract 1043.10,942,720,222,480000
06037104321,"Census Tract 1043.21, Los Angeles County, California",Census Tract 1043.21,924,322,602,488400
06037104322,"Census Tract 1043.22, Los Angeles County, California",Census Tract 1043.22,473,313,160,507000
06037104401,"Census Tract 1044.01, Los Angeles County, California",Census Tract 1044.01,617,348,269,464400
06037104403,"Census Tract 1044.03, Los Angeles County, California",Census Tract 1044.03,578,389,189,526200
06037104404,"Census Tract 1044.04, Los Angeles County, California",Census Tract 1044.04,745,327,418,508100
06037104500,"Census Tract 1045, Los Angeles County, California",Census Tract 1045,626,484,142,477900
06037104610,"Census Tract 1046.10, Los Angeles County, California",Census Tract 1046.10,680,417,263,452200
06037104620,"Census Tract 1046.20, Los Angeles County, California",Census Tract 1046.20,702,469,233,478900
06037104701,"Census Tract 1047.01, Los Angeles County, California",Census Tract 1047.01,871,227,644,477500
06037104703,"Census Tract 1047.03, Los Angeles County, California",Census Tract 1047.03,573,225,348,505400
06037104704,"Census Tract 1047.04, Los Angeles County, California",Census Tract 1047.04,1209,810,399,259500
06037104821,"Census Tract 1048.21, Los Angeles County, California",Census Tract 1048.21,716,315,401,446700
06037104822,"Census Tract 1048.22, Los Angeles County, California",Census Tract 1048.22,645,201,444,519500
06037104823,"Census Tract 1048.23, Los Angeles County, California",Census Tract 1048.23,697,544,153,462400
06037104824,"Census Tract 1048.24, Los Angeles County, California",Census Tract 1048.24,535,422,113,532000
06037106010,"Census Tract 1060.10, Los Angeles County, California",Census Tract 1060.10,902,695,207,583400
06037106020,"Census Tract 1060.20, Los Angeles County, California",Census Tract 1060.20,1295,1020,275,560300
06037106111,"Census Tract 1061.11, Los Angeles County, California",Census Tract 1061.11,1396,1289,107,549100
06037106112,"Census Tract 1061.12, Los Angeles County, California",Census Tract 1061.12,1384,1215,169,567400
06037106113,"Census Tract 1061.13, Los Angeles County, California",Census Tract 1061.13,992,815,177,536300
06037106114,"Census Tract 1061.14, Los Angeles County, California",Census Tract 1061.14,1672,843,829,427100
06037106403,"Census Tract 1064.03, Los Angeles County, California",Census Tract 1064.03,853,629,224,516000
06037106405,"Census Tract 1064.05, Los Angeles County, California",Census Tract 1064.05,1179,705,474,431800
06037106406,"Census Tract 1064.06, Los Angeles County, California",Census Tract 1064.06,1806,1434,372,413800
06037106407,"Census Tract 1064.07, Los Angeles County, California",Census Tract 1064.07,831,151,680,333100
06037106408,"Census Tract 1064.08, Los Angeles County, California",Census Tract 1064.08,990,178,812,410700
06037106510,"Census Tract 1065.10, Los Angeles County, California",Census Tract 1065.10,1625,1181,444,586600
06037106520,"Census Tract 1065.20, Los Angeles County, California",Census Tract 1065.20,1422,905,517,495500
06037106603,"Census Tract 1066.03, Los Angeles County, California",Census Tract 1066.03,1184,1093,91,834300
06037106604,"Census Tract 1066.04, Los Angeles County, California",Census Tract 1066.04,1240,575,665,586300
06037106641,"Census Tract 1066.41, Los Angeles County, California",Census Tract 1066.41,742,651,91,800300
06037106642,"Census Tract 1066.42, Los Angeles County, California",Census Tract 1066.42,1152,1062,90,704500
06037106643,"Census Tract 1066.43, Los Angeles County, California",Census Tract 1066.43,1368,1236,132,937600
06037106645,"Census Tract 1066.45, Los Angeles County, California",Census Tract 1066.45,1259,1099,160,809000
06037106646,"Census Tract 1066.46, Los Angeles County, California",Census Tract 1066.46,951,845,106,630800
06037106648,"Census Tract 1066.48, Los Angeles County, California",Census Tract 1066.48,1085,491,594,483800
06037106649,"Census Tract 1066.49, Los Angeles County, California",Census Tract 1066.49,638,504,134,615700
06037107010,"Census Tract 1070.10, Los Angeles County, California",Census Tract 1070.10,742,568,174,495800
06037107020,"Census Tract 1070.20, Los Angeles County, California",Census Tract 1070.20,1169,834,335,441400
06037108101,"Census Tract 1081.01, Los Angeles County, California",Census Tract 1081.01,765,651,114,804900
06037108102,"Census Tract 1081.02, Los Angeles County, California",Census Tract 1081.02,1141,1015,126,802300
06037108103,"Census Tract 1081.03, Los Angeles County, California",Census Tract 1081.03,981,888,93,918200
06037108104,"Census Tract 1081.04, Los Angeles County, California",Census Tract 1081.04,559,489,70,861800
06037108202,"Census Tract 1082.02, Los Angeles County, California",Census Tract 1082.02,3002,2050,952,969500
06037108203,"Census Tract 1082.03, Los Angeles County, California",Census Tract 1082.03,1148,804,344,753000
06037108204,"Census Tract 1082.04, Los Angeles County, California",Census Tract 1082.04,650,589,61,774200
06037109100,"Census Tract 1091, Los Angeles County, California",Census Tract 1091,808,578,230,478500
06037109200,"Census Tract 1092, Los Angeles County, California",Census Tract 1092,1013,843,170,642200
06037109300,"Census Tract 1093, Los Angeles County, California",Census Tract 1093,927,827,100,618000
06037109400,"Census Tract 1094, Los Angeles County, California",Census Tract 1094,1126,794,332,463600
06037109500,"Census Tract 1095, Los Angeles County, California",Census Tract 1095,1011,680,331,587600
06037109601,"Census Tract 1096.01, Los Angeles County, California",Census Tract 1096.01,1348,1190,158,614200
06037109603,"Census Tract 1096.03, Los Angeles County, California",Census Tract 1096.03,1274,772,502,596800
06037109604,"Census Tract 1096.04, Los Angeles County, California",Census Tract 1096.04,885,675,210,555000
06037109700,"Census Tract 1097, Los Angeles County, California",Census Tract 1097,1376,1031,345,607500
06037109800,"Census Tract 1098, Los Angeles County, California",Census Tract 1098,1457,1029,428,626900
06037111100,"Census Tract 1111, Los Angeles County, California",Census Tract 1111,949,623,326,624200
06037111201,"Census Tract 1112.01, Los Angeles County, California",Census Tract 1112.01,1036,899,137,696800
06037111202,"Census Tract 1112.02, Los Angeles County, California",Census Tract 1112.02,1879,1166,713,649500
06037111204,"Census Tract 1112.04, Los Angeles County, California",Census Tract 1112.04,1831,1622,209,897500
06037111205,"Census Tract 1112.05, Los Angeles County, California",Census Tract 1112.05,1294,649,645,568700
06037111206,"Census Tract 1112.06, Los Angeles County, California",Census Tract 1112.06,1425,1328,97,786400
06037111302,"Census Tract 1113.02, Los Angeles County, California",Census Tract 1113.02,1756,845,911,661100
06037111303,"Census Tract 1113.03, Los Angeles County, California",Census Tract 1113.03,1441,932,509,654300
06037111304,"Census Tract 1113.04, Los Angeles County, California",Census Tract 1113.04,1332,42,1290,
06037111401,"Census Tract 1114.01, Los Angeles County, California",Census Tract 1114.01,679,469,210,635500
06037111402,"Census Tract 1114.02, Los Angeles County, California",Census Tract 1114.02,2166,418,1748,631700
06037113101,"Census Tract 1131.01, Los Angeles County, California",Census Tract 1131.01,1152,1012,140,721200
06037113102,"Census Tract 1131.02, Los Angeles County, California",Census Tract 1131.02,954,892,62,997400
06037113211,"Census Tract 1132.11, Los Angeles County, California",Census Tract 1132.11,1607,1179,428,613300
06037113212,"Census Tract 1132.12, Los Angeles County, California",Census Tract 1132.12,945,540,405,628500
06037113213,"Census Tract 1132.13, Los Angeles County, California",Census Tract 1132.13,1712,1135,577,621000
06037113231,"Census Tract 1132.31, Los Angeles County, California",Census Tract 1132.31,833,700,133,819800
06037113232,"Census Tract 1132.32, Los Angeles County, California",Census Tract 1132.32,1500,1193,307,761800
06037113234,"Census Tract 1132.34, Los Angeles County, California",Census Tract 1132.34,1599,697,902,
06037113235,"Census Tract 1132.35, Los Angeles County, California",Census Tract 1132.35,646,441,205,574700
06037113237,"Census Tract 1132.37, Los Angeles County, California",Census Tract 1132.37,1595,1088,507,763600
06037113238,"Census Tract 1132.38, Los Angeles County, California",Census Tract 1132.38,1451,356,1095,418800
06037113239,"Census Tract 1132.39, Los Angeles County, California",Census Tract 1132.39,896,300,596,
06037113301,"Census Tract 1133.01, Los Angeles County, California",Census Tract 1133.01,1525,717,808,890000
06037113303,"Census Tract 1133.03, Los Angeles County, California",Census Tract 1133.03,1284,1061,223,626100
06037113322,"Census Tract 1133.22, Los Angeles County, California",Census Tract 1133.22,1530,1139,391,721800
06037113323,"Census Tract 1133.23, Los Angeles County, California",Census Tract 1133.23,1506,446,1060,529000
06037113324,"Census Tract 1133.24, Los Angeles County, California",Census Tract 1133.24,989,111,878,361700
06037113423,"Census Tract 1134.23, Los Angeles County, California",Census Tract 1134.23,878,597,281,615200
06037113424,"Census Tract 1134.24, Los Angeles County, California",Census Tract 1134.24,1017,716,301,622900
06037113425,"Census Tract 1134.25, Los Angeles County, California",Census Tract 1134.25,1373,64,1309,411100
06037113426,"Census Tract 1134.26, Los Angeles County, California",Census Tract 1134.26,737,371,366,631300
06037113427,"Census Tract 1134.27, Los Angeles County, California",Census Tract 1134.27,957,292,665,412500
06037113428,"Census Tract 1134.28, Los Angeles County, California",Census Tract 1134.28,1083,919,164,572600
06037115101,"Census Tract 1151.01, Los Angeles County, California",Census Tract 1151.01,1844,1624,220,904600
06037115103,"Census Tract 1151.03, Los Angeles County, California",Census Tract 1151.03,5,0,5,
06037115104,"Census Tract 1151.04, Los Angeles County, California",Census Tract 1151.04,2026,590,1436,486000
06037115202,"Census Tract 1152.02, Los Angeles County, California",Census Tract 1152.02,2005,866,1139,622600
06037115203,"Census Tract 1152.03, Los Angeles County, California",Census Tract 1152.03,1069,233,836,920400
06037115204,"Census Tract 1152.04, Los Angeles County, California",Census Tract 1152.04,1604,525,1079,664800
06037115301,"Census Tract 1153.01, Los Angeles County, California",Census Tract 1153.01,1635,823,812,692300
06037115302,"Census Tract 1153.02, Los Angeles County, California",Census Tract 1153.02,1083,357,726,622700
06037115401,"Census Tract 1154.01, Los Angeles County, California",Census Tract 1154.01,1926,688,1238,738500
06037115403,"Census Tract 1154.03, Los Angeles County, California",Census Tract 1154.03,1022,267,755,634400
06037115404,"Census Tract 1154.04, Los Angeles County, California",Census Tract 1154.04,800,381,419,612800
06037117101,"Census Tract 1171.01, Los Angeles County, California",Census Tract 1171.01,1453,958,495,500600
06037117102,"Census Tract 1171.02, Los Angeles County, California",Census Tract 1171.02,815,624,191,577700
06037117201,"Census Tract 1172.01, Los Angeles County, California",Census Tract 1172.01,1190,373,817,565300
06037117202,"Census Tract 1172.02, Los Angeles County, California",Census Tract 1172.02,929,658,271,610600
06037117301,"Census Tract 1173.01, Los Angeles County, California",Census Tract 1173.01,1092,849,243,630300
06037117302,"Census Tract 1173.02, Los Angeles County, California",Census Tract 1173.02,1557,1212,345,634800
06037117303,"Census Tract 1173.03, Los Angeles County, California",Census Tract 1173.03,1180,972,208,651000
06037117404,"Census Tract 1174.04, Los Angeles County, California",Census Tract 1174.04,1375,1050,325,655300
06037117405,"Census Tract 1174.05, Los Angeles County, California",Census Tract 1174.05,861,77,784,278500
06037117407,"Census Tract 1174.07, Los Angeles County, California",Census Tract 1174.07,1007,5,1002,
06037117408,"Census Tract 1174.08, Los Angeles County, California",Census Tract 1174.08,716,101,615,477300
06037117510,"Census Tract 1175.10, Los Angeles County, California",Census Tract 1175.10,1033,157,876,354600
06037117520,"Census Tract 1175.20, Los Angeles County, California",Census Tract 1175.20,1077,153,924,431200
06037117530,"Census Tract 1175.30, Los Angeles County, California",Census Tract 1175.30,1699,322,1377,419700
06037119001,"Census Tract 1190.01, Los Angeles County, California",Census Tract 1190.01,1012,823,189,545700
06037119003,"Census Tract 1190.03, Los Angeles County, California",Census Tract 1190.03,860,696,164,485300
06037119004,"Census Tract 1190.04, Los Angeles County, California",Census Tract 1190.04,759,544,215,563400
06037119201,"Census Tract 1192.01, Los Angeles County, California",Census Tract 1192.01,849,703,146,550100
06037119202,"Census Tract 1192.02, Los Angeles County, California",Census Tract 1192.02,1133,893,240,499800
06037119310,"Census Tract 1193.10, Los Angeles County, California",Census Tract 1193.10,1243,685,558,386700
06037119320,"Census Tract 1193.20, Los Angeles County, California",Census Tract 1193.20,1270,369,901,436700
06037119340,"Census Tract 1193.40, Los Angeles County, California",Census Tract 1193.40,1029,3,1026,
06037119341,"Census Tract 1193.41, Los Angeles County, California",Census Tract 1193.41,857,343,514,408900
06037119342,"Census Tract 1193.42, Los Angeles County, California",Census Tract 1193.42,782,384,398,338700
06037119400,"Census Tract 1194, Los Angeles County, California",Census Tract 1194,1147,999,148,555200
06037119700,"Census Tract 1197, Los Angeles County, California",Census Tract 1197,1301,1066,235,604200
06037119801,"Census Tract 1198.01, Los Angeles County, California",Census Tract 1198.01,618,504,114,543200
06037119802,"Census Tract 1198.02, Los Angeles County, California",Census Tract 1198.02,810,566,244,539900
06037119900,"Census Tract 1199, Los Angeles County, California",Census Tract 1199,1260,1002,258,500500
06037120010,"Census Tract 1200.10, Los Angeles County, California",Census Tract 1200.10,761,310,451,493800
06037120020,"Census Tract 1200.20, Los Angeles County, California",Census Tract 1200.20,1256,220,1036,531700
06037120030,"Census Tract 1200.30, Los Angeles County, California",Census Tract 1200.30,702,35,667,588000
06037120103,"Census Tract 1201.03, Los Angeles County, California",Census Tract 1201.03,847,61,786,450000
06037120104,"Census Tract 1201.04, Los Angeles County, California",Census Tract 1201.04,794,75,719,463700
06037120105,"Census Tract 1201.05, Los Angeles County, California",Census Tract 1201.05,851,239,612,464600
06037120106,"Census Tract 1201.06, Los Angeles County, California",Census Tract 1201.06,1318,304,1014,
06037120107,"Census Tract 1201.07, Los Angeles County, California",Census Tract 1201.07,1116,49,1067,425000
06037120108,"Census Tract 1201.08, Los Angeles County, California",Census Tract 1201.08,1399,469,930,346900
06037120300,"Census Tract 1203, Los Angeles County, California",Census Tract 1203,1424,928,496,573800
06037120400,"Census Tract 1204, Los Angeles County, California",Census Tract 1204,2099,728,1371,566000
06037121010,"Census Tract 1210.10, Los Angeles County, California",Census Tract 1210.10,1258,895,363,604900
06037121020,"Census Tract 1210.20, Los Angeles County, California",Census Tract 1210.20,1055,623,432,611100
06037121101,"Census Tract 1211.01, Los Angeles County, California",Census Tract 1211.01,949,374,575,471900
06037121102,"Census Tract 1211.02, Los Angeles County, California",Census Tract 1211.02,755,485,270,570800
06037121210,"Census Tract 1212.10, Los Angeles County, California",Census Tract 1212.10,781,515,266,558500
06037121221,"Census Tract 1212.21, Los Angeles County, California",Census Tract 1212.21,517,406,111,538800
06037121222,"Census Tract 1212.22, Los Angeles County, California",Census Tract 1212.22,1233,546,687,596600
06037121600,"Census Tract 1216, Los Angeles County, California",Census Tract 1216,837,684,153,619200
06037121801,"Census Tract 1218.01, Los Angeles County, California",Census Tract 1218.01,1118,279,839,575500
06037121802,"Census Tract 1218.02, Los Angeles County, California",Census Tract 1218.02,708,455,253,605000
06037121900,"Census Tract 1219, Los Angeles County, California",Census Tract 1219,1009,451,558,605400
06037122000,"Census Tract 1220, Los Angeles County, California",Census Tract 1220,1576,1041,535,612600
06037122120,"Census Tract 1221.20, Los Angeles County, California",Census Tract 1221.20,1185,668,517,598100
06037122121,"Census Tract 1221.21, Los Angeles County, California",Census Tract 1221.21,771,316,455,528900
06037122122,"Census Tract 1221.22, Los Angeles County, California",Census Tract 1221.22,638,157,481,397900
06037122200,"Census Tract 1222, Los Angeles County, California",Census Tract 1222,860,438,422,566900
06037122410,"Census Tract 1224.10, Los Angeles County, California",Census Tract 1224.10,1172,198,974,519200
06037122420,"Census Tract 1224.20, Los Angeles County, California",Census Tract 1224.20,1340,425,915,638200
06037123010,"Census Tract 1230.10, Los Angeles County, California",Census Tract 1230.10,1005,332,673,577800
06037123020,"Census Tract 1230.20, Los Angeles County, California",Census Tract 1230.20,753,438,315,514400
06037123103,"Census Tract 1231.03, Los Angeles County, California",Census Tract 1231.03,1619,617,1002,588300
06037123104,"Census Tract 1231.04, Los Angeles County, California",Census Tract 1231.04,1581,550,1031,679300
06037123203,"Census Tract 1232.03, Los Angeles County, California",Census Tract 1232.03,981,124,857,603300
06037123204,"Census Tract 1232.04, Los Angeles County, California",Census Tract 1232.04,1016,194,822,706300
06037123205,"Census Tract 1232.05, Los Angeles County, California",Census Tract 1232.05,764,152,612,718800
06037123206,"Census Tract 1232.06, Los Angeles County, California",Census Tract 1232.06,792,170,622,532300
06037123301,"Census Tract 1233.01, Los Angeles County, California",Census Tract 1233.01,1625,679,946,531300
06037123303,"Census Tract 1233.03, Los Angeles County, California",Census Tract 1233.03,893,294,599,634400
06037123304,"Census Tract 1233.04, Los Angeles County, California",Census Tract 1233.04,1749,403,1346,648900
06037123410,"Census Tract 1234.10, Los Angeles County, California",Census Tract 1234.10,1212,263,949,602300
06037123420,"Census Tract 1234.20, Los Angeles County, California",Census Tract 1234.20,1623,535,1088,623300
06037123510,"Census Tract 1235.10, Los Angeles County, California",Census Tract 1235.10,1621,352,1269,780000
06037123520,"Census Tract 1235.20, Los Angeles County, California",Census Tract 1235.20,761,292,469,678100
06037123601,"Census Tract 1236.01, Los Angeles County, California",Census Tract 1236.01,1897,779,1118,646300
06037123602,"Census Tract 1236.02, Los Angeles County, California",Census Tract 1236.02,1235,535,700,846000
06037123700,"Census Tract 1237, Los Angeles County, California",Census Tract 1237,1672,742,930,641800
06037123800,"Census Tract 1238, Los Angeles County, California",Census Tract 1238,2237,1033,1204,844500
06037123901,"Census Tract 1239.01, Los Angeles County, California",Census Tract 1239.01,1402,502,900,741100
06037123902,"Census Tract 1239.02, Los Angeles County, California",Census Tract 1239.02,1084,413,671,825500
06037124000,"Census Tract 1240, Los Angeles County, California",Census Tract 1240,2113,983,1130,1037300
06037124102,"Census Tract 1241.02, Los Angeles County, California",Census Tract 1241.02,1360,283,1077,789400
06037124103,"Census Tract 1241.03, Los Angeles County, California",Census Tract 1241.03,570,198,372,678300
06037124104,"Census Tract 1241.04, Los Angeles County, California",Census Tract 1241.04,1015,146,869,746200
06037124105,"Census Tract 1241.05, Los Angeles County, California",Census Tract 1241.05,848,142,706,605100
06037124201,"Census Tract 1242.01, Los Angeles County, California",Census Tract 1242.01,1069,577,492,643800
06037124203,"Census Tract 1242.03, Los Angeles County, California",Census Tract 1242.03,793,242,551,676900
06037124204,"Census Tract 1242.04, Los Angeles County, California",Census Tract 1242.04,873,105,768,433900
06037124300,"Census Tract 1243, Los Angeles County, California",Census Tract 1243,1210,365,845,729200
06037124400,"Census Tract 1244, Los Angeles County, California",Census Tract 1244,1643,500,1143,940500
06037124500,"Census Tract 1245, Los Angeles County, California",Census Tract 1245,1218,638,580,865700
06037124600,"Census Tract 1246, Los Angeles County, California",Census Tract 1246,1252,428,824,930500
06037124700,"Census Tract 1247, Los Angeles County, California",Census Tract 1247,2427,1019,1408,999400
06037124902,"Census Tract 1249.02, Los Angeles County, California",Census Tract 1249.02,1556,233,1323,813000
06037124903,"Census Tract 1249.03, Los Angeles County, California",Census Tract 1249.03,1567,355,1212,566800
06037125101,"Census Tract 1251.01, Los Angeles County, California",Census Tract 1251.01,2032,358,1674,536600
06037125102,"Census Tract 1251.02, Los Angeles County, California",Census Tract 1251.02,834,367,467,1394200
06037125200,"Census Tract 1252, Los Angeles County, California",Census Tract 1252,1774,498,1276,896200
06037125310,"Census Tract 1253.10, Los Angeles County, California",Census Tract 1253.10,1959,279,1680,831100
06037125321,"Census Tract 1253.21, Los Angeles County, California",Census Tract 1253.21,1382,119,1263,461600
06037125322,"Census Tract 1253.22, Los Angeles County, California",Census Tract 1253.22,1359,0,1359,
06037125402,"Census Tract 1254.02, Los Angeles County, California",Census Tract 1254.02,2037,450,1587,728800
06037125403,"Census Tract 1254.03, Los Angeles County, California",Census Tract 1254.03,1248,68,1180,356700
06037125404,"Census Tract 1254.04, Los Angeles County, California",Census Tract 1254.04,1553,0,1553,
06037125501,"Census Tract 1255.01, Los Angeles County, California",Census Tract 1255.01,1609,168,1441,710700
06037125502,"Census Tract 1255.02, Los Angeles County, California",Census Tract 1255.02,1974,479,1495,701100
06037125600,"Census Tract 1256, Los Angeles County, California",Census Tract 1256,1243,618,625,1250000
06037127102,"Census Tract 1271.02, Los Angeles County, California",Census Tract 1271.02,1515,594,921,454300
06037127103,"Census Tract 1271.03, Los Angeles County, California",Census Tract 1271.03,1215,214,1001,340400
06037127104,"Census Tract 1271.04, Los Angeles County, California",Census Tract 1271.04,1404,426,978,595000
06037127210,"Census Tract 1272.10, Los Angeles County, California",Census Tract 1272.10,1879,527,1352,536300
06037127220,"Census Tract 1272.20, Los Angeles County, California",Census Tract 1272.20,1681,498,1183,540500
06037127300,"Census Tract 1273, Los Angeles County, California",Census Tract 1273,1337,485,852,605900
06037127400,"Census Tract 1274, Los Angeles County, California",Census Tract 1274,1917,519,1398,529800
06037127520,"Census Tract 1275.20, Los Angeles County, California",Census Tract 1275.20,1482,52,1430,256700
06037127603,"Census Tract 1276.03, Los Angeles County, California",Census Tract 1276.03,918,116,802,613600
06037127604,"Census Tract 1276.04, Los Angeles County, California",Census Tract 1276.04,1431,176,1255,529700
06037127605,"Census Tract 1276.05, Los Angeles County, California",Census Tract 1276.05,1182,185,997,612400
06037127606,"Census Tract 1276.06, Los Angeles County, California",Census Tract 1276.06,1106,360,746,593500
06037127711,"Census Tract 1277.11, Los Angeles County, California",Census Tract 1277.11,1113,464,649,708900
06037127712,"Census Tract 1277.12, Los Angeles County, California",Census Tract 1277.12,1540,207,1333,640900
06037127803,"Census Tract 1278.03, Los Angeles County, California",Census Tract 1278.03,1643,375,1268,605100
06037127804,"Census Tract 1278.04, Los Angeles County, California",Census Tract 1278.04,1575,376,1199,499000
06037127805,"Census Tract 1278.05, Los Angeles County, California",Census Tract 1278.05,1241,251,990,690300
06037127806,"Census Tract 1278.06, Los Angeles County, California",Census Tract 1278.06,1143,268,875,572700
06037127910,"Census Tract 1279.10, Los Angeles County, California",Census Tract 1279.10,1449,343,1106,598900
06037127920,"Census Tract 1279.20, Los Angeles County, California",Census Tract 1279.20,1483,604,879,625600
06037128101,"Census Tract 1281.01, Los Angeles County, California",Census Tract 1281.01,1065,309,756,696000
06037128102,"Census Tract 1281.02, Los Angeles County, California",Census Tract 1281.02,1557,299,1258,596900
06037128210,"Census Tract 1282.10, Los Angeles County, California",Census Tract 1282.10,1584,53,1531,450000
06037128220,"Census Tract 1282.20, Los Angeles County, California",Census Tract 1282.20,1175,349,826,665100
06037128302,"Census Tract 1283.02, Los Angeles County, California",Census Tract 1283.02,1488,200,1288,566700
06037128303,"Census Tract 1283.03, Los Angeles County, California",Census Tract 1283.03,1154,82,1072,372200
06037128400,"Census Tract 1284, Los Angeles County, California",Census Tract 1284,1781,1023,758,781900
06037128500,"Census Tract 1285, Los Angeles County, California",Census Tract 1285,2077,893,1184,698000
06037128601,"Census Tract 1286.01, Los Angeles County, California",Census Tract 1286.01,1673,309,1364,771300
06037128602,"Census Tract 1286.02, Los Angeles County, California",Census Tract 1286.02,1270,598,672,929700
06037128703,"Census Tract 1287.03, Los Angeles County, California",Census Tract 1287.03,1598,313,1285,611700
06037128704,"Census Tract 1287.04, Los Angeles County, California",Census Tract 1287.04,934,548,386,917400
06037128801,"Census Tract 1288.01, Los Angeles County, California",Census Tract 1288.01,1929,465,1464,655200
06037128802,"Census Tract 1288.02, Los Angeles County, California",Census Tract 1288.02,1954,658,1296,836900
06037128910,"Census Tract 1289.10, Los Angeles County, California",Census Tract 1289.10,1846,926,920,952000
06037131021,"Census Tract 1310.21, Los Angeles County, California",Census Tract 1310.21,1029,197,832,625000
06037131022,"Census Tract 1310.22, Los Angeles County, California",Census Tract 1310.22,1011,143,868,616000
06037131023,"Census Tract 1310.23, Los Angeles County, California",Census Tract 1310.23,844,410,434,542700
06037131024,"Census Tract 1310.24, Los Angeles County, California",Census Tract 1310.24,1002,497,505,579600
06037131100,"Census Tract 1311, Los Angeles County, California",Census Tract 1311,1047,928,119,626600
06037131200,"Census Tract 1312, Los Angeles County, California",Census Tract 1312,1220,929,291,612900
06037131300,"Census Tract 1313, Los Angeles County, California",Census Tract 1313,1186,878,308,597600
06037131400,"Census Tract 1314, Los Angeles County, California",Census Tract 1314,1840,845,995,535500
06037131600,"Census Tract 1316, Los Angeles County, California",Census Tract 1316,1305,1111,194,565000
06037131701,"Census Tract 1317.01, Los Angeles County, California",Census Tract 1317.01,1906,930,976,539300
06037131702,"Census Tract 1317.02, Los Angeles County, California",Census Tract 1317.02,1243,858,385,597700
06037131801,"Census Tract 1318.01, Los Angeles County, California",Census Tract 1318.01,979,144,835,532900
06037131802,"Census Tract 1318.02, Los Angeles County, California",Census Tract 1318.02,742,601,141,591000
06037131900,"Census Tract 1319, Los Angeles County, California",Census Tract 1319,1361,1040,321,623400
06037132001,"Census Tract 1320.01, Los Angeles County, California",Census Tract 1320.01,1188,739,449,605700
06037132002,"Census Tract 1320.02, Los Angeles County, California",Census Tract 1320.02,1145,657,488,632700
06037132101,"Census Tract 1321.01, Los Angeles County, California",Census Tract 1321.01,1591,638,953,627900
06037132102,"Census Tract 1321.02, Los Angeles County, California",Census Tract 1321.02,2141,952,1189,551900
06037132301,"Census Tract 1323.01, Los Angeles County, California",Census Tract 1323.01,1373,97,1276,357600
06037132302,"Census Tract 1323.02, Los Angeles County, California",Census Tract 1323.02,977,406,571,600700
06037132501,"Census Tract 1325.01, Los Angeles County, California",Census Tract 1325.01,1274,554,720,594600
06037132502,"Census Tract 1325.02, Los Angeles County, California",Census Tract 1325.02,1206,665,541,435000
06037132700,"Census Tract 1327, Los Angeles County, California",Census Tract 1327,1660,939,721,618000
06037132900,"Census Tract 1329, Los Angeles County, California",Census Tract 1329,1304,724,580,677500
06037133000,"Census Tract 1330, Los Angeles County, California",Census Tract 1330,1437,1051,386,548300
06037133101,"Census Tract 1331.01, Los Angeles County, California",Census Tract 1331.01,606,360,246,657100
06037133102,"Census Tract 1331.02, Los Angeles County, California",Census Tract 1331.02,1372,455,917,671200
06037134001,"Census Tract 1340.01, Los Angeles County, California",Census Tract 1340.01,948,351,597,476400
06037134002,"Census Tract 1340.02, Los Angeles County, California",Census Tract 1340.02,1203,495,708,575200
06037134101,"Census Tract 1341.01, Los Angeles County, California",Census Tract 1341.01,1313,726,587,633700
06037134103,"Census Tract 1341.03, Los Angeles County, California",Census Tract 1341.03,1267,723,544,604500
06037134104,"Census Tract 1341.04, Los Angeles County, California",Census Tract 1341.04,1298,609,689,598300
06037134201,"Census Tract 1342.01, Los Angeles County, California",Census Tract 1342.01,1314,1045,269,620500
06037134302,"Census Tract 1343.02, Los Angeles County, California",Census Tract 1343.02,1369,1121,248,647700
06037134303,"Census Tract 1343.03, Los Angeles County, California",Census Tract 1343.03,1912,1388,524,573700
06037134304,"Census Tract 1343.04, Los Angeles County, California",Census Tract 1343.04,940,605,335,604400
06037134305,"Census Tract 1343.05, Los Angeles County, California",Census Tract 1343.05,1188,28,1160,
06037134306,"Census Tract 1343.06, Los Angeles County, California",Census Tract 1343.06,1463,339,1124,527100
06037134421,"Census Tract 1344.21, Los Angeles County, California",Census Tract 1344.21,1490,1332,158,860800
06037134422,"Census Tract 1344.22, Los Angeles County, California",Census Tract 1344.22,1546,1263,283,772400
06037134423,"Census Tract 1344.23, Los Angeles County, California",Census Tract 1344.23,1314,988,326,796200
06037134424,"Census Tract 1344.24, Los Angeles County, California",Census Tract 1344.24,1020,910,110,966200
06037134520,"Census Tract 1345.20, Los Angeles County, California",Census Tract 1345.20,1868,227,1641,387800
06037134521,"Census Tract 1345.21, Los Angeles County, California",Census Tract 1345.21,755,108,647,533700
06037134522,"Census Tract 1345.22, Los Angeles County, California",Census Tract 1345.22,1437,281,1156,434300
06037134710,"Census Tract 1347.10, Los Angeles County, California",Census Tract 1347.10,1599,257,1342,598500
06037134720,"Census Tract 1347.20, Los Angeles County, California",Census Tract 1347.20,1759,927,832,549900
06037134801,"Census Tract 1348.01, Los Angeles County, California",Census Tract 1348.01,1094,754,340,572300
06037134802,"Census Tract 1348.02, Los Angeles County, California",Census Tract 1348.02,812,594,218,533700
06037134901,"Census Tract 1349.01, Los Angeles County, California",Census Tract 1349.01,990,592,398,672600
06037134904,"Census Tract 1349.04, Los Angeles County, California",Census Tract 1349.04,1428,620,808,613500
06037134905,"Census Tract 1349.05, Los Angeles County, California",Census Tract 1349.05,2600,331,2269,594100
06037134906,"Census Tract 1349.06, Los Angeles County, California",Census Tract 1349.06,1131,0,1131,
06037134907,"Census Tract 1349.07, Los Angeles County, California",Census Tract 1349.07,1532,0,1532,
06037135102,"Census Tract 1351.02, Los Angeles County, California",Census Tract 1351.02,1214,1064,150,676600
06037135111,"Census Tract 1351.11, Los Angeles County, California",Census Tract 1351.11,1258,635,623,660100
06037135113,"Census Tract 1351.13, Los Angeles County, California",Census Tract 1351.13,1345,185,1160,339900
06037135115,"Census Tract 1351.15, Los Angeles County, California",Census Tract 1351.15,1455,282,1173,580600
06037135116,"Census Tract 1351.16, Los Angeles County, California",Census Tract 1351.16,1000,68,932,586500
06037135201,"Census Tract 1352.01, Los Angeles County, California",Census Tract 1352.01,876,696,180,719900
06037135202,"Census Tract 1352.02, Los Angeles County, California",Census Tract 1352.02,1445,1020,425,657500
06037135204,"Census Tract 1352.04, Los Angeles County, California",Census Tract 1352.04,1625,1416,209,658000
06037135205,"Census Tract 1352.05, Los Angeles County, California",Census Tract 1352.05,771,629,142,880800
06037137000,"Census Tract 1370, Los Angeles County, California",Census Tract 1370,1718,1341,377,927400
06037137103,"Census Tract 1371.03, Los Angeles County, California",Census Tract 1371.03,2399,1164,1235,468900
06037137104,"Census Tract 1371.04, Los Angeles County, California",Census Tract 1371.04,940,803,137,761100
06037137202,"Census Tract 1372.02, Los Angeles County, California",Census Tract 1372.02,1334,437,897,817800
06037137203,"Census Tract 1372.03, Los Angeles County, California",Census Tract 1372.03,849,528,321,824000
06037137301,"Census Tract 1373.01, Los Angeles County, California",Census Tract 1373.01,710,686,24,966900
06037137302,"Census Tract 1373.02, Los Angeles County, California",Census Tract 1373.02,1541,1389,152,970000
06037137401,"Census Tract 1374.01, Los Angeles County, California",Census Tract 1374.01,1527,1001,526,867400
06037137402,"Census Tract 1374.02, Los Angeles County, California",Census Tract 1374.02,2077,1437,640,977500
06037137501,"Census Tract 1375.01, Los Angeles County, California",Census Tract 1375.01,1997,731,1266,1270300
06037137502,"Census Tract 1375.02, Los Angeles County, California",Census Tract 1375.02,1719,1254,465,863800
06037137504,"Census Tract 1375.04, Los Angeles County, California",Census Tract 1375.04,675,603,72,1467400
06037138000,"Census Tract 1380, Los Angeles County, California",Census Tract 1380,1774,1455,319,901000
06037139001,"Census Tract 1390.01, Los Angeles County, California",Census Tract 1390.01,2222,1128,1094,770400
06037139200,"Census Tract 1392, Los Angeles County, California",Census Tract 1392,2193,1183,1010,671500
06037139301,"Census Tract 1393.01, Los Angeles County, California",Census Tract 1393.01,1503,1319,184,910600
06037139302,"Census Tract 1393.02, Los Angeles County, California",Census Tract 1393.02,1907,410,1497,313900
06037139303,"Census Tract 1393.03, Los Angeles County, California",Census Tract 1393.03,2144,561,1583,418900
06037139401,"Census Tract 1394.01, Los Angeles County, California",Census Tract 1394.01,1139,331,808,853000
06037139402,"Census Tract 1394.02, Los Angeles County, California",Census Tract 1394.02,936,824,112,1511500
06037139502,"Census Tract 1395.02, Los Angeles County, California",Census Tract 1395.02,1110,677,433,904900
06037139504,"Census Tract 1395.04, Los Angeles County, California",Census Tract 1395.04,1756,442,1314,562500
06037139505,"Census Tract 1395.05, Los Angeles County, California",Census Tract 1395.05,1544,359,1185,378800
06037139506,"Census Tract 1395.06, Los Angeles County, California",Census Tract 1395.06,1494,777,717,439400
06037139600,"Census Tract 1396, Los Angeles County, California",Census Tract 1396,2240,1425,815,1261900
06037139701,"Census Tract 1397.01, Los Angeles County, California",Census Tract 1397.01,2118,1595,523,1359600
06037139703,"Census Tract 1397.03, Los Angeles County, California",Census Tract 1397.03,851,765,86,1725900
06037139704,"Census Tract 1397.04, Los Angeles County, California",Census Tract 1397.04,975,794,181,1495300
06037139705,"Census Tract 1397.05, Los Angeles County, California",Census Tract 1397.05,1284,1252,32,1738200
06037139801,"Census Tract 1398.01, Los Angeles County, California",Census Tract 1398.01,1232,1189,43,1287800
06037139802,"Census Tract 1398.02, Los Angeles County, California",Census Tract 1398.02,1380,1257,123,1254100
06037141101,"Census Tract 1411.01, Los Angeles County, California",Census Tract 1411.01,2229,574,1655,707700
06037141102,"Census Tract 1411.02, Los Angeles County, California",Census Tract 1411.02,1422,533,889,1085300
06037141201,"Census Tract 1412.01, Los Angeles County, California",Census Tract 1412.01,2079,358,1721,915200
06037141202,"Census Tract 1412.02, Los Angeles County, California",Census Tract 1412.02,1435,655,780,919500
06037141303,"Census Tract 1413.03, Los Angeles County, California",Census Tract 1413.03,1692,299,1393,551100
06037141304,"Census Tract 1413.04, Los Angeles County, California",Census Tract 1413.04,1522,722,800,1132600
06037141305,"Census Tract 1413.05, Los Angeles County, California",Census Tract 1413.05,1345,454,891,910900
06037141306,"Census Tract 1413.06, Los Angeles County, California",Census Tract 1413.06,1520,340,1180,973700
06037141400,"Census Tract 1414, Los Angeles County, California",Census Tract 1414,2028,1049,979,1229500
06037141500,"Census Tract 1415, Los Angeles County, California",Census Tract 1415,1100,1069,31,2000001
06037141600,"Census Tract 1416, Los Angeles County, California",Census Tract 1416,1758,1529,229,1395600
06037141700,"Census Tract 1417, Los Angeles County, California",Census Tract 1417,1179,1103,76,1580000
06037143101,"Census Tract 1431.01, Los Angeles County, California",Census Tract 1431.01,1086,684,402,1073800
06037143102,"Census Tract 1431.02, Los Angeles County, California",Census Tract 1431.02,1219,247,972,765100
06037143200,"Census Tract 1432, Los Angeles County, California",Census Tract 1432,2068,644,1424,854100
06037143301,"Census Tract 1433.01, Los Angeles County, California",Census Tract 1433.01,1555,335,1220,686600
06037143302,"Census Tract 1433.02, Los Angeles County, California",Census Tract 1433.02,1617,739,878,1210800
06037143401,"Census Tract 1434.01, Los Angeles County, California",Census Tract 1434.01,2289,1041,1248,939000
06037143402,"Census Tract 1434.02, Los Angeles County, California",Census Tract 1434.02,797,352,445,973400
06037143500,"Census Tract 1435, Los Angeles County, California",Census Tract 1435,2325,1152,1173,1218400
06037143602,"Census Tract 1436.02, Los Angeles County, California",Census Tract 1436.02,2213,1113,1100,899100
06037143603,"Census Tract 1436.03, Los Angeles County, California",Census Tract 1436.03,1322,413,909,767900
06037143605,"Census Tract 1436.05, Los Angeles County, California",Census Tract 1436.05,890,47,843,735000
06037143606,"Census Tract 1436.06, Los Angeles County, California",Census Tract 1436.06,975,36,939,676500
06037143700,"Census Tract 1437, Los Angeles County, California",Census Tract 1437,1725,1212,513,1537500
06037143801,"Census Tract 1438.01, Los Angeles County, California",Census Tract 1438.01,1352,799,553,1521400
06037143802,"Census Tract 1438.02, Los Angeles County, California",Census Tract 1438.02,1055,403,652,1641800
06037143901,"Census Tract 1439.01, Los Angeles County, California",Census Tract 1439.01,1599,1434,165,1800000
06037143902,"Census Tract 1439.02, Los Angeles County, California",Census Tract 1439.02,1362,741,621,1475000
06037181000,"Census Tract 1810, Los Angeles County, California",Census Tract 1810,2234,1512,722,976700
06037181300,"Census Tract 1813, Los Angeles County, California",Census Tract 1813,1281,866,415,897000
06037181400,"Census Tract 1814, Los Angeles County, California",Census Tract 1814,1663,544,1119,812900
06037181500,"Census Tract 1815, Los Angeles County, California",Census Tract 1815,1398,998,400,858800
06037181600,"Census Tract 1816, Los Angeles County, California",Census Tract 1816,1051,466,585,944400
06037183101,"Census Tract 1831.01, Los Angeles County, California",Census Tract 1831.01,1095,611,484,710000
06037183103,"Census Tract 1831.03, Los Angeles County, California",Census Tract 1831.03,1647,362,1285,720800
06037183104,"Census Tract 1831.04, Los Angeles County, California",Census Tract 1831.04,726,479,247,791400
06037183220,"Census Tract 1832.20, Los Angeles County, California",Census Tract 1832.20,1051,565,486,663200
06037183221,"Census Tract 1832.21, Los Angeles County, California",Census Tract 1832.21,1116,608,508,840100
06037183222,"Census Tract 1832.22, Los Angeles County, California",Census Tract 1832.22,1553,924,629,829400
06037183300,"Census Tract 1833, Los Angeles County, California",Census Tract 1833,1107,457,650,745300
06037183401,"Census Tract 1834.01, Los Angeles County, California",Census Tract 1834.01,827,421,406,768400
06037183402,"Census Tract 1834.02, Los Angeles County, California",Census Tract 1834.02,1037,210,827,846900
06037183510,"Census Tract 1835.10, Los Angeles County, California",Census Tract 1835.10,790,592,198,791500
06037183520,"Census Tract 1835.20, Los Angeles County, California",Census Tract 1835.20,1215,431,784,724900
06037183610,"Census Tract 1836.10, Los Angeles County, California",Census Tract 1836.10,963,296,667,728300
06037183620,"Census Tract 1836.20, Los Angeles County, California",Census Tract 1836.20,1021,470,551,830200
06037183701,"Census Tract 1837.01, Los Angeles County, California",Census Tract 1837.01,1311,459,852,480400
06037183702,"Census Tract 1837.02, Los Angeles County, California",Census Tract 1837.02,1100,526,574,958300
06037183810,"Census Tract 1838.10, Los Angeles County, California",Census Tract 1838.10,1459,263,1196,771800
06037183820,"Census Tract 1838.20, Los Angeles County, California",Census Tract 1838.20,1208,167,1041,799700
06037185101,"Census Tract 1851.01, Los Angeles County, California",Census Tract 1851.01,951,259,692,785900
06037185102,"Census Tract 1851.02, Los Angeles County, California",Census Tract 1851.02,1386,1066,320,974400
06037185202,"Census Tract 1852.02, Los Angeles County, California",Census Tract 1852.02,1481,769,712,944200
06037185203,"Census Tract 1852.03, Los Angeles County, California",Census Tract 1852.03,884,316,568,719400
06037185204,"Census Tract 1852.04, Los Angeles County, California",Census Tract 1852.04,726,520,206,920200
06037185310,"Census Tract 1853.10, Los Angeles County, California",Census Tract 1853.10,889,323,566,628600
06037185320,"Census Tract 1853.20, Los Angeles County, California",Census Tract 1853.20,902,370,532,603700
06037186100,"Census Tract 1861, Los Angeles County, California",Census Tract 1861,1862,1088,774,834100
06037186201,"Census Tract 1862.01, Los Angeles County, California",Census Tract 1862.01,1280,507,773,861200
06037186202,"Census Tract 1862.02, Los Angeles County, California",Census Tract 1862.02,695,314,381,755400
06037186203,"Census Tract 1862.03, Los Angeles County, California",Census Tract 1862.03,1071,843,228,863900
06037186301,"Census Tract 1863.01, Los Angeles County, California",Census Tract 1863.01,818,231,587,740700
06037186302,"Census Tract 1863.02, Los Angeles County, California",Census Tract 1863.02,1854,1154,700,861800
06037186401,"Census Tract 1864.01, Los Angeles County, California",Census Tract 1864.01,876,126,750,540700
06037186403,"Census Tract 1864.03, Los Angeles County, California",Census Tract 1864.03,787,318,469,720300
06037186404,"Census Tract 1864.04, Los Angeles County, California",Census Tract 1864.04,793,232,561,694700
06037187101,"Census Tract 1871.01, Los Angeles County, California",Census Tract 1871.01,1196,596,600,943400
06037187102,"Census Tract 1871.02, Los Angeles County, California",Census Tract 1871.02,1597,628,969,832200
06037187200,"Census Tract 1872, Los Angeles County, California",Census Tract 1872,1036,401,635,638600
06037187300,"Census Tract 1873, Los Angeles County, California",Census Tract 1873,1579,644,935,1080400
06037188100,"Census Tract 1881, Los Angeles County, California",Census Tract 1881,1831,423,1408,852000
06037188201,"Census Tract 1882.01, Los Angeles County, California",Census Tract 1882.01,1554,325,1229,1081500
06037188202,"Census Tract 1882.02, Los Angeles County, California",Census Tract 1882.02,1251,751,500,2000001
06037188300,"Census Tract 1883, Los Angeles County, California",Census Tract 1883,1379,584,795,964100
06037189101,"Census Tract 1891.01, Los Angeles County, California",Census Tract 1891.01,1214,265,949,1071900
06037189102,"Census Tract 1891.02, Los Angeles County, California",Census Tract 1891.02,1967,458,1509,951300
06037189201,"Census Tract 1892.01, Los Angeles County, California",Census Tract 1892.01,1748,156,1592,866100
06037189202,"Census Tract 1892.02, Los Angeles County, California",Census Tract 1892.02,1289,522,767,1950800
06037189300,"Census Tract 1893, Los Angeles County, California",Census Tract 1893,1353,1285,68,1835700
06037189400,"Census Tract 1894, Los Angeles County, California",Census Tract 1894,1548,838,710,1541100
06037189501,"Census Tract 1895.01, Los Angeles County, California",Census Tract 1895.01,1474,295,1179,871000
06037189502,"Census Tract 1895.02, Los Angeles County, California",Census Tract 1895.02,1311,134,1177,1360000
06037189600,"Census Tract 1896, Los Angeles County, California",Census Tract 1896,1988,702,1286,1246800
06037189702,"Census Tract 1897.02, Los Angeles County, California",Census Tract 1897.02,1268,531,737,1708300
06037189703,"Census Tract 1897.03, Los Angeles County, California",Census Tract 1897.03,998,603,395,1529000
06037189704,"Census Tract 1897.04, Los Angeles County, California",Census Tract 1897.04,686,391,295,1393600
06037189801,"Census Tract 1898.01, Los Angeles County, California",Census Tract 1898.01,1290,325,965,
06037189802,"Census Tract 1898.02, Los Angeles County, California",Census Tract 1898.02,1065,339,726,1008900
06037189903,"Census Tract 1899.03, Los Angeles County, California",Census Tract 1899.03,1594,501,1093,570200
06037189904,"Census Tract 1899.04, Los Angeles County, California",Census Tract 1899.04,1436,29,1407,
06037189905,"Census Tract 1899.05, Los Angeles County, California",Census Tract 1899.05,1351,270,1081,696700
06037189906,"Census Tract 1899.06, Los Angeles County, California",Census Tract 1899.06,1379,75,1304,
06037189907,"Census Tract 1899.07, Los Angeles County, California",Census Tract 1899.07,1404,56,1348,1008600
06037190101,"Census Tract 1901.01, Los Angeles County, California",Census Tract 1901.01,1197,0,1197,
06037190102,"Census Tract 1901.02, Los Angeles County, California",Census Tract 1901.02,1351,65,1286,671300
06037190201,"Census Tract 1902.01, Los Angeles County, California",Census Tract 1902.01,1415,4,1411,
06037190202,"Census Tract 1902.02, Los Angeles County, California",Census Tract 1902.02,2266,39,2227,
06037190302,"Census Tract 1903.02, Los Angeles County, California",Census Tract 1903.02,1172,164,1008,822200
06037190303,"Census Tract 1903.03, Los Angeles County, California",Census Tract 1903.03,1704,16,1688,
06037190401,"Census Tract 1904.01, Los Angeles County, California",Census Tract 1904.01,1639,17,1622,477300
06037190402,"Census Tract 1904.02, Los Angeles County, California",Census Tract 1904.02,1229,3,1226,
06037190510,"Census Tract 1905.10, Los Angeles County, California",Census Tract 1905.10,1595,0,1595,
06037190520,"Census Tract 1905.20, Los Angeles County, California",Census Tract 1905.20,1531,144,1387,562500
06037190701,"Census Tract 1907.01, Los Angeles County, California",Census Tract 1907.01,835,77,758,1130300
06037190702,"Census Tract 1907.02, Los Angeles County, California",Census Tract 1907.02,724,84,640,1194400
06037190801,"Census Tract 1908.01, Los Angeles County, California",Census Tract 1908.01,1244,72,1172,833300
06037190802,"Census Tract 1908.02, Los Angeles County, California",Census Tract 1908.02,1423,158,1265,750000
06037190901,"Census Tract 1909.01, Los Angeles County, California",Census Tract 1909.01,1193,73,1120,863800
06037190902,"Census Tract 1909.02, Los Angeles County, California",Census Tract 1909.02,1536,89,1447,1088800
06037191000,"Census Tract 1910, Los Angeles County, California",Census Tract 1910,2991,162,2829,553300
06037191110,"Census Tract 1911.10, Los Angeles County, California",Census Tract 1911.10,1016,37,979,677900
06037191120,"Census Tract 1911.20, Los Angeles County, California",Census Tract 1911.20,1600,132,1468,1042900
06037191201,"Census Tract 1912.01, Los Angeles County, California",Census Tract 1912.01,1680,67,1613,709400
06037191203,"Census Tract 1912.03, Los Angeles County, California",Census Tract 1912.03,1038,48,990,693500
06037191204,"Census Tract 1912.04, Los Angeles County, California",Census Tract 1912.04,698,50,648,850000
06037191301,"Census Tract 1913.01, Los Angeles County, California",Census Tract 1913.01,953,175,778,776500
06037191302,"Census Tract 1913.02, Los Angeles County, California",Census Tract 1913.02,809,91,718,664200
06037191410,"Census Tract 1914.10, Los Angeles County, California",Census Tract 1914.10,1390,67,1323,646700
06037191420,"Census Tract 1914.20, Los Angeles County, California",Census Tract 1914.20,1123,151,972,920500
06037191500,"Census Tract 1915, Los Angeles County, California",Census Tract 1915,1793,351,1442,883800
06037191610,"Census Tract 1916.10, Los Angeles County, California",Census Tract 1916.10,1371,145,1226,1169100
06037191620,"Census Tract 1916.20, Los Angeles County, California",Census Tract 1916.20,1003,46,957,796900
06037191710,"Census Tract 1917.10, Los Angeles County, California",Census Tract 1917.10,1187,55,1132,476400
06037191720,"Census Tract 1917.20, Los Angeles County, California",Census Tract 1917.20,1339,64,1275,894700
06037191810,"Census Tract 1918.10, Los Angeles County, California",Census Tract 1918.10,1226,52,1174,675700
06037191820,"Census Tract 1918.20, Los Angeles County, California",Census Tract 1918.20,1810,118,1692,824400
06037191901,"Census Tract 1919.01, Los Angeles County, California",Census Tract 1919.01,1976,83,1893,912500
06037191902,"Census Tract 1919.02, Los Angeles County, California",Census Tract 1919.02,1485,669,816,1335600
06037192001,"Census Tract 1920.01, Los Angeles County, California",Census Tract 1920.01,1015,205,810,1558500
06037192002,"Census Tract 1920.02, Los Angeles County, California",Census Tract 1920.02,1326,772,554,1345100
06037192300,"Census Tract 1923, Los Angeles County, California",Census Tract 1923,1369,474,895,1106800
06037192410,"Census Tract 1924.10, Los Angeles County, California",Census Tract 1924.10,1780,608,1172,1143100
06037192420,"Census Tract 1924.20, Los Angeles County, California",Census Tract 1924.20,1338,143,1195,882900
06037192510,"Census Tract 1925.10, Los Angeles County, California",Census Tract 1925.10,1251,263,988,706600
06037192520,"Census Tract 1925.20, Los Angeles County, California",Census Tract 1925.20,1570,125,1445,632800
06037192610,"Census Tract 1926.10, Los Angeles County, California",Census Tract 1926.10,1420,69,1351,1093200
06037192620,"Census Tract 1926.20, Los Angeles County, California",Census Tract 1926.20,1146,45,1101,598700
06037192700,"Census Tract 1927, Los Angeles County, California",Census Tract 1927,1205,140,1065,767900
06037194101,"Census Tract 1941.01, Los Angeles County, California",Census Tract 1941.01,1753,609,1144,2000001
06037194102,"Census Tract 1941.02, Los Angeles County, California",Census Tract 1941.02,1372,1110,262,1881900
06037194200,"Census Tract 1942, Los Angeles County, California",Census Tract 1942,1590,1113,477,1962900
06037194300,"Census Tract 1943, Los Angeles County, California",Census Tract 1943,1387,1101,286,2000001
06037194401,"Census Tract 1944.01, Los Angeles County, California",Census Tract 1944.01,1316,227,1089,1606300
06037194402,"Census Tract 1944.02, Los Angeles County, California",Census Tract 1944.02,2097,762,1335,998500
06037194500,"Census Tract 1945, Los Angeles County, California",Census Tract 1945,940,391,549,1770800
06037195100,"Census Tract 1951, Los Angeles County, California",Census Tract 1951,2128,1280,848,1493000
06037195201,"Census Tract 1952.01, Los Angeles County, California",Census Tract 1952.01,1547,326,1221,1467000
06037195202,"Census Tract 1952.02, Los Angeles County, California",Census Tract 1952.02,1412,653,759,1258300
06037195300,"Census Tract 1953, Los Angeles County, California",Census Tract 1953,1378,300,1078,859200
06037195400,"Census Tract 1954, Los Angeles County, California",Census Tract 1954,2204,1015,1189,1229500
06037195500,"Census Tract 1955, Los Angeles County, California",Census Tract 1955,2419,1010,1409,910800
06037195600,"Census Tract 1956, Los Angeles County, California",Census Tract 1956,1205,373,832,805100
06037195710,"Census Tract 1957.10, Los Angeles County, California",Census Tract 1957.10,1542,186,1356,1006100
06037195720,"Census Tract 1957.20, Los Angeles County, California",Census Tract 1957.20,824,158,666,655000
06037195802,"Census Tract 1958.02, Los Angeles County, California",Census Tract 1958.02,1029,227,802,897000
06037195803,"Census Tract 1958.03, Los Angeles County, California",Census Tract 1958.03,1063,272,791,1061500
06037195804,"Census Tract 1958.04, Los Angeles County, California",Census Tract 1958.04,1122,200,922,1102300
06037195901,"Census Tract 1959.01, Los Angeles County, California",Census Tract 1959.01,1114,161,953,1306800
06037195902,"Census Tract 1959.02, Los Angeles County, California",Census Tract 1959.02,991,261,730,1176600
06037195903,"Census Tract 1959.03, Los Angeles County, California",Census Tract 1959.03,889,154,735,838700
06037197200,"Census Tract 1972, Los Angeles County, California",Census Tract 1972,1179,579,600,666200
06037197300,"Census Tract 1973, Los Angeles County, California",Census Tract 1973,1778,480,1298,1034000
06037197410,"Census Tract 1974.10, Los Angeles County, California",Census Tract 1974.10,1769,824,945,1067800
06037197420,"Census Tract 1974.20, Los Angeles County, California",Census Tract 1974.20,1574,493,1081,938300
06037197500,"Census Tract 1975, Los Angeles County, California",Census Tract 1975,1641,294,1347,942100
06037197600,"Census Tract 1976, Los Angeles County, California",Census Tract 1976,840,165,675,770800
06037197700,"Census Tract 1977, Los Angeles County, California",Census Tract 1977,2044,283,1761,613500
06037199001,"Census Tract 1990.01, Los Angeles County, California",Census Tract 1990.01,673,48,625,621000
06037199002,"Census Tract 1990.02, Los Angeles County, California",Census Tract 1990.02,993,197,796,470300
06037199110,"Census Tract 1991.10, Los Angeles County, California",Census Tract 1991.10,786,462,324,581900
06037199120,"Census Tract 1991.20, Los Angeles County, California",Census Tract 1991.20,1109,202,907,563300
06037199201,"Census Tract 1992.01, Los Angeles County, California",Census Tract 1992.01,1113,299,814,497500
06037199202,"Census Tract 1992.02, Los Angeles County, California",Census Tract 1992.02,920,492,428,672600
06037199300,"Census Tract 1993, Los Angeles County, California",Census Tract 1993,1324,762,562,688600
06037199400,"Census Tract 1994, Los Angeles County, California",Census Tract 1994,1476,364,1112,600500
06037199700,"Census Tract 1997, Los Angeles County, California",Census Tract 1997,1213,258,955,637800
06037199801,"Census Tract 1998.01, Los Angeles County, California",Census Tract 1998.01,889,355,534,544400
06037199802,"Census Tract 1998.02, Los Angeles County, California",Census Tract 1998.02,615,219,396,582500
06037199900,"Census Tract 1999, Los Angeles County, California",Census Tract 1999,852,157,695,553800
06037201110,"Census Tract 2011.10, Los Angeles County, California",Census Tract 2011.10,773,534,239,657900
06037201120,"Census Tract 2011.20, Los Angeles County, California",Census Tract 2011.20,1244,475,769,633000
06037201200,"Census Tract 2012, Los Angeles County, California",Census Tract 2012,764,427,337,623100
06037201301,"Census Tract 2013.01, Los Angeles County, California",Census Tract 2013.01,1045,514,531,645100
06037201302,"Census Tract 2013.02, Los Angeles County, California",Census Tract 2013.02,1806,1250,556,549300
06037201401,"Census Tract 2014.01, Los Angeles County, California",Census Tract 2014.01,1265,603,662,560100
06037201402,"Census Tract 2014.02, Los Angeles County, California",Census Tract 2014.02,1508,1065,443,618100
06037201501,"Census Tract 2015.01, Los Angeles County, California",Census Tract 2015.01,1506,644,862,608400
06037201503,"Census Tract 2015.03, Los Angeles County, California",Census Tract 2015.03,989,310,679,531000
06037201504,"Census Tract 2015.04, Los Angeles County, California",Census Tract 2015.04,610,350,260,607000
06037201601,"Census Tract 2016.01, Los Angeles County, California",Census Tract 2016.01,716,419,297,578100
06037201602,"Census Tract 2016.02, Los Angeles County, California",Census Tract 2016.02,771,428,343,614600
06037201700,"Census Tract 2017, Los Angeles County, California",Census Tract 2017,1424,801,623,569600
06037203100,"Census Tract 2031, Los Angeles County, California",Census Tract 2031,1280,157,1123,610400
06037203200,"Census Tract 2032, Los Angeles County, California",Census Tract 2032,1324,422,902,492300
06037203300,"Census Tract 2033, Los Angeles County, California",Census Tract 2033,423,106,317,483300
06037203500,"Census Tract 2035, Los Angeles County, California",Census Tract 2035,970,309,661,558600
06037203601,"Census Tract 2036.01, Los Angeles County, California",Census Tract 2036.01,809,113,696,438300
06037203602,"Census Tract 2036.02, Los Angeles County, California",Census Tract 2036.02,573,157,416,578300
06037203710,"Census Tract 2037.10, Los Angeles County, California",Census Tract 2037.10,832,216,616,586700
06037203720,"Census Tract 2037.20, Los Angeles County, California",Census Tract 2037.20,1019,282,737,618900
06037203800,"Census Tract 2038, Los Angeles County, California",Census Tract 2038,1266,449,817,428600
06037203900,"Census Tract 2039, Los Angeles County, California",Census Tract 2039,715,272,443,502000
06037204110,"Census Tract 2041.10, Los Angeles County, California",Census Tract 2041.10,837,370,467,498700
06037204120,"Census Tract 2041.20, Los Angeles County, California",Census Tract 2041.20,701,190,511,463300
06037204200,"Census Tract 2042, Los Angeles County, California",Census Tract 2042,1008,237,771,449600
06037204300,"Census Tract 2043, Los Angeles County, California",Census Tract 2043,1335,421,914,497500
06037204410,"Census Tract 2044.10, Los Angeles County, California",Census Tract 2044.10,673,78,595,551000
06037204420,"Census Tract 2044.20, Los Angeles County, California",Census Tract 2044.20,864,68,796,443600
06037204600,"Census Tract 2046, Los Angeles County, California",Census Tract 2046,1137,304,833,442300
06037204700,"Census Tract 2047, Los Angeles County, California",Census Tract 2047,1241,646,595,513700
06037204810,"Census Tract 2048.10, Los Angeles County, California",Census Tract 2048.10,1357,467,890,477800
06037204820,"Census Tract 2048.20, Los Angeles County, California",Census Tract 2048.20,530,230,300,485300
06037204910,"Census Tract 2049.10, Los Angeles County, California",Census Tract 2049.10,950,155,795,546900
06037204920,"Census Tract 2049.20, Los Angeles County, California",Census Tract 2049.20,679,240,439,483000
06037205110,"Census Tract 2051.10, Los Angeles County, California",Census Tract 2051.10,851,0,851,
06037205120,"Census Tract 2051.20, Los Angeles County, California",Census Tract 2051.20,885,99,786,465800
06037206010,"Census Tract 2060.10, Los Angeles County, California",Census Tract 2060.10,1474,100,1374,806800
06037206020,"Census Tract 2060.20, Los Angeles County, California",Census Tract 2060.20,262,0,262,
06037206050,"Census Tract 2060.50, Los Angeles County, California",Census Tract 2060.50,805,16,789,450000
06037206051,"Census Tract 2060.51, Los Angeles County, California",Census Tract 2060.51,796,350,446,895800
06037206052,"Census Tract 2060.52, Los Angeles County, California",Census Tract 2060.52,1787,101,1686,645500
06037206053,"Census Tract 2060.53, Los Angeles County, California",Census Tract 2060.53,1156,149,1007,622800
06037206054,"Census Tract 2060.54, Los Angeles County, California",Census Tract 2060.54,628,84,544,
06037206201,"Census Tract 2062.01, Los Angeles County, California",Census Tract 2062.01,1203,71,1132,510100
06037206202,"Census Tract 2062.02, Los Angeles County, California",Census Tract 2062.02,1225,239,986,472100
06037206301,"Census Tract 2063.01, Los Angeles County, California",Census Tract 2063.01,1063,31,1032,
06037206302,"Census Tract 2063.02, Los Angeles County, California",Census Tract 2063.02,631,0,631,
06037206303,"Census Tract 2063.03, Los Angeles County, California",Census Tract 2063.03,629,0,629,
06037207101,"Census Tract 2071.01, Los Angeles County, California",Census Tract 2071.01,1670,31,1639,
06037207102,"Census Tract 2071.02, Los Angeles County, California",Census Tract 2071.02,1406,41,1365,795000
06037207103,"Census Tract 2071.03, Los Angeles County, California",Census Tract 2071.03,903,20,883,607100
06037207303,"Census Tract 2073.03, Los Angeles County, California",Census Tract 2073.03,1722,32,1690,818200
06037207304,"Census Tract 2073.04, Los Angeles County, California",Census Tract 2073.04,1673,31,1642,
06037207305,"Census Tract 2073.05, Los Angeles County, California",Census Tract 2073.05,568,48,520,
06037207306,"Census Tract 2073.06, Los Angeles County, California",Census Tract 2073.06,1422,149,1273,647300
06037207307,"Census Tract 2073.07, Los Angeles County, California",Census Tract 2073.07,1161,0,1161,
06037207308,"Census Tract 2073.08, Los Angeles County, California",Census Tract 2073.08,802,0,802,
06037207400,"Census Tract 2074, Los Angeles County, California",Census Tract 2074,734,0,734,
06037207501,"Census Tract 2075.01, Los Angeles County, California",Census Tract 2075.01,1241,168,1073,720100
06037207502,"Census Tract 2075.02, Los Angeles County, California",Census Tract 2075.02,2385,0,2385,
06037207711,"Census Tract 2077.11, Los Angeles County, California",Census Tract 2077.11,1337,236,1101,814500
06037207712,"Census Tract 2077.12, Los Angeles County, California",Census Tract 2077.12,2730,289,2441,768400
06037207901,"Census Tract 2079.01, Los Angeles County, California",Census Tract 2079.01,1793,90,1703,625000
06037207902,"Census Tract 2079.02, Los Angeles County, California",Census Tract 2079.02,3928,343,3585,910700
06037208001,"Census Tract 2080.01, Los Angeles County, California",Census Tract 2080.01,1132,15,1117,
06037208002,"Census Tract 2080.02, Los Angeles County, California",Census Tract 2080.02,1262,147,1115,705100
06037208301,"Census Tract 2083.01, Los Angeles County, California",Census Tract 2083.01,575,35,540,
06037208302,"Census Tract 2083.02, Los Angeles County, California",Census Tract 2083.02,1787,254,1533,831100
06037208401,"Census Tract 2084.01, Los Angeles County, California",Census Tract 2084.01,1437,31,1406,703900
06037208402,"Census Tract 2084.02, Los Angeles County, California",Census Tract 2084.02,840,127,713,784800
06037208501,"Census Tract 2085.01, Los Angeles County, California",Census Tract 2085.01,850,103,747,858800
06037208502,"Census Tract 2085.02, Los Angeles County, California",Census Tract 2085.02,1464,0,1464,
06037208610,"Census Tract 2086.10, Los Angeles County, California",Census Tract 2086.10,1515,130,1385,776800
06037208620,"Census Tract 2086.20, Los Angeles County, California",Census Tract 2086.20,1536,207,1329,678900
06037208710,"Census Tract 2087.10, Los Angeles County, California",Census Tract 2087.10,2072,243,1829,421000
06037208720,"Census Tract 2087.20, Los Angeles County, California",Census Tract 2087.20,1499,29,1470,
06037208801,"Census Tract 2088.01, Los Angeles County, California",Census Tract 2088.01,1369,18,1351,
06037208802,"Census Tract 2088.02, Los Angeles County, California",Census Tract 2088.02,1495,9,1486,
06037208902,"Census Tract 2089.02, Los Angeles County, California",Census Tract 2089.02,688,0,688,
06037208903,"Census Tract 2089.03, Los Angeles County, California",Census Tract 2089.03,1090,12,1078,
06037208904,"Census Tract 2089.04, Los Angeles County, California",Census Tract 2089.04,1373,18,1355,
06037209103,"Census Tract 2091.03, Los Angeles County, California",Census Tract 2091.03,1112,0,1112,
06037209104,"Census Tract 2091.04, Los Angeles County, California",Census Tract 2091.04,967,0,967,
06037209105,"Census Tract 2091.05, Los Angeles County, California",Census Tract 2091.05,1029,0,1029,
06037209106,"Census Tract 2091.06, Los Angeles County, California",Census Tract 2091.06,1194,113,1081,
06037209201,"Census Tract 2092.01, Los Angeles County, California",Census Tract 2092.01,1831,146,1685,662900
06037209202,"Census Tract 2092.02, Los Angeles County, California",Census Tract 2092.02,562,0,562,
06037209300,"Census Tract 2093, Los Angeles County, California",Census Tract 2093,2125,19,2106,
06037209401,"Census Tract 2094.01, Los Angeles County, California",Census Tract 2094.01,1547,20,1527,
06037209402,"Census Tract 2094.02, Los Angeles County, California",Census Tract 2094.02,1193,36,1157,
06037209403,"Census Tract 2094.03, Los Angeles County, California",Census Tract 2094.03,1492,18,1474,
06037209510,"Census Tract 2095.10, Los Angeles County, California",Census Tract 2095.10,966,8,958,
06037209520,"Census Tract 2095.20, Los Angeles County, California",Census Tract 2095.20,929,3,926,
06037209810,"Census Tract 2098.10, Los Angeles County, California",Census Tract 2098.10,743,25,718,
06037209820,"Census Tract 2098.20, Los Angeles County, California",Census Tract 2098.20,782,103,679,720100
06037210010,"Census Tract 2100.10, Los Angeles County, California",Census Tract 2100.10,1266,138,1128,398200
06037211000,"Census Tract 2110, Los Angeles County, California",Census Tract 2110,2002,1207,795,2000001
06037211121,"Census Tract 2111.21, Los Angeles County, California",Census Tract 2111.21,899,49,850,
06037211122,"Census Tract 2111.22, Los Angeles County, California",Census Tract 2111.22,1072,23,1049,
06037211123,"Census Tract 2111.23, Los Angeles County, California",Census Tract 2111.23,891,25,866,
06037211124,"Census Tract 2111.24, Los Angeles County, California",Census Tract 2111.24,2052,139,1913,483700
06037211201,"Census Tract 2112.01, Los Angeles County, California",Census Tract 2112.01,1034,59,975,692700
06037211202,"Census Tract 2112.02, Los Angeles County, California",Census Tract 2112.02,896,25,871,843800
06037211310,"Census Tract 2113.10, Los Angeles County, California",Census Tract 2113.10,1346,86,1260,695500
06037211320,"Census Tract 2113.20, Los Angeles County, California",Census Tract 2113.20,1246,9,1237,
06037211410,"Census Tract 2114.10, Los Angeles County, California",Census Tract 2114.10,1078,121,957,1563600
06037211420,"Census Tract 2114.20, Los Angeles County, California",Census Tract 2114.20,1314,206,1108,945700
06037211500,"Census Tract 2115, Los Angeles County, California",Census Tract 2115,1743,531,1212,1399300
06037211701,"Census Tract 2117.01, Los Angeles County, California",Census Tract 2117.01,1128,477,651,
06037211703,"Census Tract 2117.03, Los Angeles County, California",Census Tract 2117.03,2063,203,1860,456200
06037211704,"Census Tract 2117.04, Los Angeles County, California",Census Tract 2117.04,1573,153,1420,535300
06037211802,"Census Tract 2118.02, Los Angeles County, California",Census Tract 2118.02,2074,139,1935,
06037211803,"Census Tract 2118.03, Los Angeles County, California",Census Tract 2118.03,1512,126,1386,400000
06037211804,"Census Tract 2118.04, Los Angeles County, California",Census Tract 2118.04,1309,4,1305,
06037211910,"Census Tract 2119.10, Los Angeles County, California",Census Tract 2119.10,1869,55,1814,376400
06037211921,"Census Tract 2119.21, Los Angeles County, California",Census Tract 2119.21,949,0,949,
06037211922,"Census Tract 2119.22, Los Angeles County, California",Census Tract 2119.22,1346,9,1337,
06037212101,"Census Tract 2121.01, Los Angeles County, California",Census Tract 2121.01,1443,151,1292,525600
06037212102,"Census Tract 2121.02, Los Angeles County, California",Census Tract 2121.02,1188,15,1173,
06037212202,"Census Tract 2122.02, Los Angeles County, California",Census Tract 2122.02,1249,42,1207,909100
06037212203,"Census Tract 2122.03, Los Angeles County, California",Census Tract 2122.03,1500,0,1500,
06037212204,"Census Tract 2122.04, Los Angeles County, California",Census Tract 2122.04,1271,18,1253,
06037212303,"Census Tract 2123.03, Los Angeles County, California",Census Tract 2123.03,1618,19,1599,
06037212304,"Census Tract 2123.04, Los Angeles County, California",Census Tract 2123.04,731,10,721,
06037212305,"Census Tract 2123.05, Los Angeles County, California",Census Tract 2123.05,945,18,927,
06037212306,"Census Tract 2123.06, Los Angeles County, California",Census Tract 2123.06,1095,21,1074,511400
06037212410,"Census Tract 2124.10, Los Angeles County, California",Census Tract 2124.10,1497,42,1455,604200
06037212420,"Census Tract 2124.20, Los Angeles County, California",Census Tract 2124.20,1163,24,1139,
06037212501,"Census Tract 2125.01, Los Angeles County, California",Census Tract 2125.01,900,24,876,1092100
06037212502,"Census Tract 2125.02, Los Angeles County, California",Census Tract 2125.02,1323,81,1242,768900
06037212610,"Census Tract 2126.10, Los Angeles County, California",Census Tract 2126.10,1808,360,1448,802600
06037212620,"Census Tract 2126.20, Los Angeles County, California",Census Tract 2126.20,1739,72,1667,869000
06037212701,"Census Tract 2127.01, Los Angeles County, California",Census Tract 2127.01,796,328,468,1089300
06037212702,"Census Tract 2127.02, Los Angeles County, California",Census Tract 2127.02,1378,583,795,1094500
06037212800,"Census Tract 2128, Los Angeles County, California",Census Tract 2128,1369,605,764,1102400
06037212900,"Census Tract 2129, Los Angeles County, California",Census Tract 2129,1440,160,1280,1028600
06037213100,"Census Tract 2131, Los Angeles County, California",Census Tract 2131,1033,279,754,1050300
06037213201,"Census Tract 2132.01, Los Angeles County, California",Census Tract 2132.01,1625,135,1490,786900
06037213202,"Census Tract 2132.02, Los Angeles County, California",Census Tract 2132.02,1269,235,1034,638400
06037213310,"Census Tract 2133.10, Los Angeles County, California",Census Tract 2133.10,900,148,752,663700
06037213320,"Census Tract 2133.20, Los Angeles County, California",Census Tract 2133.20,976,81,895,648800
06037213401,"Census Tract 2134.01, Los Angeles County, California",Census Tract 2134.01,1607,23,1584,
06037213402,"Census Tract 2134.02, Los Angeles County, California",Census Tract 2134.02,1715,122,1593,790200
06037214000,"Census Tract 2140, Los Angeles County, California",Census Tract 2140,1259,702,557,1902000
06037214100,"Census Tract 2141, Los Angeles County, California",Census Tract 2141,1676,688,988,2000001
06037214400,"Census Tract 2144, Los Angeles County, California",Census Tract 2144,1759,38,1721,2000001
06037214501,"Census Tract 2145.01, Los Angeles County, California",Census Tract 2145.01,1543,54,1489,
06037214503,"Census Tract 2145.03, Los Angeles County, California",Census Tract 2145.03,1431,30,1401,
06037214504,"Census Tract 2145.04, Los Angeles County, California",Census Tract 2145.04,1596,75,1521,852300
06037214505,"Census Tract 2145.05, Los Angeles County, California",Census Tract 2145.05,897,0,897,
06037214600,"Census Tract 2146, Los Angeles County, California",Census Tract 2146,1211,228,983,
06037214700,"Census Tract 2147, Los Angeles County, California",Census Tract 2147,1141,513,628,1863800
06037214800,"Census Tract 2148, Los Angeles County, California",Census Tract 2148,1418,350,1068,1512200
06037214902,"Census Tract 2149.02, Los Angeles County, California",Census Tract 2149.02,1481,374,1107,859600
06037214903,"Census Tract 2149.03, Los Angeles County, California",Census Tract 2149.03,1073,205,868,714700
06037214904,"Census Tract 2149.04, Los Angeles County, California",Census Tract 2149.04,868,263,605,1058100
06037215101,"Census Tract 2151.01, Los Angeles County, California",Census Tract 2151.01,1749,85,1664,662500
06037215102,"Census Tract 2151.02, Los Angeles County, California",Census Tract 2151.02,1952,22,1930,
06037216100,"Census Tract 2161, Los Angeles County, California",Census Tract 2161,920,553,367,1510800
06037216201,"Census Tract 2162.01, Los Angeles County, California",Census Tract 2162.01,1385,324,1061,1923100
06037216202,"Census Tract 2162.02, Los Angeles County, California",Census Tract 2162.02,1372,381,991,1160000
06037216301,"Census Tract 2163.01, Los Angeles County, California",Census Tract 2163.01,627,471,156,1784300
06037216302,"Census Tract 2163.02, Los Angeles County, California",Census Tract 2163.02,1644,291,1353,910500
06037216401,"Census Tract 2164.01, Los Angeles County, California",Census Tract 2164.01,1679,131,1548,834200
06037216402,"Census Tract 2164.02, Los Angeles County, California",Census Tract 2164.02,1179,157,1022,802100
06037216700,"Census Tract 2167, Los Angeles County, California",Census Tract 2167,1555,595,960,1149800
06037216800,"Census Tract 2168, Los Angeles County, California",Census Tract 2168,1364,501,863,1570300
06037216901,"Census Tract 2169.01, Los Angeles County, California",Census Tract 2169.01,1311,750,561,1097800
06037216902,"Census Tract 2169.02, Los Angeles County, California",Census Tract 2169.02,1147,211,936,1305100
06037217001,"Census Tract 2170.01, Los Angeles County, California",Census Tract 2170.01,973,428,545,1442700
06037217002,"Census Tract 2170.02, Los Angeles County, California",Census Tract 2170.02,1896,413,1483,1135700
06037217101,"Census Tract 2171.01, Los Angeles County, California",Census Tract 2171.01,897,126,771,1555600
06037217102,"Census Tract 2171.02, Los Angeles County, California",Census Tract 2171.02,1260,415,845,1145500
06037217200,"Census Tract 2172, Los Angeles County, California",Census Tract 2172,1632,471,1161,1152700
06037218110,"Census Tract 2181.10, Los Angeles County, California",Census Tract 2181.10,1268,221,1047,987100
06037218120,"Census Tract 2181.20, Los Angeles County, California",Census Tract 2181.20,1296,306,990,669000
06037218210,"Census Tract 2182.10, Los Angeles County, California",Census Tract 2182.10,1166,198,968,826900
06037218220,"Census Tract 2182.20, Los Angeles County, California",Census Tract 2182.20,1386,469,917,1078700
06037218300,"Census Tract 2183, Los Angeles County, California",Census Tract 2183,2314,618,1696,872100
06037218400,"Census Tract 2184, Los Angeles County, California",Census Tract 2184,1351,409,942,689300
06037218500,"Census Tract 2185, Los Angeles County, California",Census Tract 2185,972,254,718,845700
06037218600,"Census Tract 2186, Los Angeles County, California",Census Tract 2186,1140,353,787,687900
06037218701,"Census Tract 2187.01, Los Angeles County, California",Census Tract 2187.01,819,307,512,761800
06037218702,"Census Tract 2187.02, Los Angeles County, California",Census Tract 2187.02,839,195,644,758700
06037218800,"Census Tract 2188, Los Angeles County, California",Census Tract 2188,979,192,787,826300
06037218900,"Census Tract 2189, Los Angeles County, California",Census Tract 2189,2181,257,1924,990800
06037219010,"Census Tract 2190.10, Los Angeles County, California",Census Tract 2190.10,1011,488,523,708200
06037219020,"Census Tract 2190.20, Los Angeles County, California",Census Tract 2190.20,1366,742,624,719800
06037219300,"Census Tract 2193, Los Angeles County, California",Census Tract 2193,1432,263,1169,720500
06037219500,"Census Tract 2195, Los Angeles County, California",Census Tract 2195,781,559,222,774600
06037219700,"Census Tract 2197, Los Angeles County, California",Census Tract 2197,1315,720,595,650500
06037219800,"Census Tract 2198, Los Angeles County, California",Census Tract 2198,941,326,615,631300
06037219901,"Census Tract 2199.01, Los Angeles County, California",Census Tract 2199.01,1514,317,1197,550500
06037219902,"Census Tract 2199.02, Los Angeles County, California",Census Tract 2199.02,1082,538,544,668800
06037220000,"Census Tract 2200, Los Angeles County, California",Census Tract 2200,2117,610,1507,625000
06037220100,"Census Tract 2201, Los Angeles County, California",Census Tract 2201,1064,529,535,855100
06037221110,"Census Tract 2211.10, Los Angeles County, California",Census Tract 2211.10,1069,157,912,796900
06037221120,"Census Tract 2211.20, Los Angeles County, California",Census Tract 2211.20,794,67,727,667800
06037221210,"Census Tract 2212.10, Los Angeles County, California",Census Tract 2212.10,869,267,602,848100
06037221220,"Census Tract 2212.20, Los Angeles County, California",Census Tract 2212.20,925,194,731,611600
06037221302,"Census Tract 2213.02, Los Angeles County, California",Census Tract 2213.02,1180,156,1024,693200
06037221303,"Census Tract 2213.03, Los Angeles County, California",Census Tract 2213.03,703,76,627,912500
06037221304,"Census Tract 2213.04, Los Angeles County, California",Census Tract 2213.04,1160,85,1075,643600
06037221401,"Census Tract 2214.01, Los Angeles County, California",Census Tract 2214.01,1107,163,944,645200
06037221402,"Census Tract 2214.02, Los Angeles County, California",Census Tract 2214.02,913,263,650,1165800
06037221500,"Census Tract 2215, Los Angeles County, California",Census Tract 2215,1059,209,850,869100
06037221601,"Census Tract 2216.01, Los Angeles County, California",Census Tract 2216.01,958,162,796,750000
06037221602,"Census Tract 2216.02, Los Angeles County, California",Census Tract 2216.02,914,109,805,645400
06037221710,"Census Tract 2217.10, Los Angeles County, California",Census Tract 2217.10,936,141,795,615300
06037221810,"Census Tract 2218.10, Los Angeles County, California",Census Tract 2218.10,900,60,840,645800
06037221820,"Census Tract 2218.20, Los Angeles County, California",Census Tract 2218.20,905,72,833,836400
06037221900,"Census Tract 2219, Los Angeles County, California",Census Tract 2219,870,74,796,656800
06037222001,"Census Tract 2220.01, Los Angeles County, California",Census Tract 2220.01,956,516,440,713700
06037222002,"Census Tract 2220.02, Los Angeles County, California",Census Tract 2220.02,1409,618,791,598400
06037222100,"Census Tract 2221, Los Angeles County, California",Census Tract 2221,1204,409,795,666900
06037222200,"Census Tract 2222, Los Angeles County, California",Census Tract 2222,1292,327,965,824600
06037222500,"Census Tract 2225, Los Angeles County, California",Census Tract 2225,1180,411,769,575700
06037222600,"Census Tract 2226, Los Angeles County, California",Census Tract 2226,1610,240,1370,509300
06037222700,"Census Tract 2227, Los Angeles County, California",Census Tract 2227,103,0,103,
06037224010,"Census Tract 2240.10, Los Angeles County, California",Census Tract 2240.10,1614,8,1606,
06037224020,"Census Tract 2240.20, Los Angeles County, California",Census Tract 2240.20,905,35,870,738600
06037224200,"Census Tract 2242, Los Angeles County, California",Census Tract 2242,749,49,700,745000
06037224310,"Census Tract 2243.10, Los Angeles County, California",Census Tract 2243.10,560,36,524,826900
06037224320,"Census Tract 2243.20, Los Angeles County, California",Census Tract 2243.20,1129,47,1082,619800
06037224410,"Census Tract 2244.10, Los Angeles County, California",Census Tract 2244.10,1075,207,868,774500
06037224420,"Census Tract 2244.20, Los Angeles County, California",Census Tract 2244.20,888,64,824,739100
06037224600,"Census Tract 2246, Los Angeles County, California",Census Tract 2246,794,125,669,692100
06037224701,"Census Tract 2247.01, Los Angeles County, California",Census Tract 2247.01,271,11,260,
06037224702,"Census Tract 2247.02, Los Angeles County, California",Census Tract 2247.02,691,0,691,
06037226001,"Census Tract 2260.01, Los Angeles County, California",Census Tract 2260.01,601,88,513,434000
06037226002,"Census Tract 2260.02, Los Angeles County, California",Census Tract 2260.02,1177,109,1068,573200
06037226410,"Census Tract 2264.10, Los Angeles County, California",Census Tract 2264.10,864,107,757,518600
06037226420,"Census Tract 2264.20, Los Angeles County, California",Census Tract 2264.20,1357,259,1098,573000
06037226701,"Census Tract 2267.01, Los Angeles County, California",Census Tract 2267.01,641,274,367,443000
06037226702,"Census Tract 2267.02, Los Angeles County, California",Census Tract 2267.02,900,353,547,482600
06037227010,"Census Tract 2270.10, Los Angeles County, California",Census Tract 2270.10,1077,164,913,432100
06037227020,"Census Tract 2270.20, Los Angeles County, California",Census Tract 2270.20,782,214,568,385700
06037228100,"Census Tract 2281, Los Angeles County, California",Census Tract 2281,1221,552,669,436800
06037228210,"Census Tract 2282.10, Los Angeles County, California",Census Tract 2282.10,1022,280,742,437400
06037228220,"Census Tract 2282.20, Los Angeles County, California",Census Tract 2282.20,966,304,662,460900
06037228310,"Census Tract 2283.10, Los Angeles County, California",Census Tract 2283.10,1051,248,803,447100
06037228320,"Census Tract 2283.20, Los Angeles County, California",Census Tract 2283.20,727,147,580,403800
06037228410,"Census Tract 2284.10, Los Angeles County, California",Census Tract 2284.10,732,139,593,458000
06037228420,"Census Tract 2284.20, Los Angeles County, California",Census Tract 2284.20,672,169,503,478400
06037228500,"Census Tract 2285, Los Angeles County, California",Census Tract 2285,1137,325,812,404000
06037228600,"Census Tract 2286, Los Angeles County, California",Census Tract 2286,1107,267,840,574200
06037228710,"Census Tract 2287.10, Los Angeles County, California",Census Tract 2287.10,1000,258,742,386800
06037228720,"Census Tract 2287.20, Los Angeles County, California",Census Tract 2287.20,1139,347,792,462500
06037228800,"Census Tract 2288, Los Angeles County, California",Census Tract 2288,1245,500,745,439300
06037228900,"Census Tract 2289, Los Angeles County, California",Census Tract 2289,789,120,669,441700
06037229100,"Census Tract 2291, Los Angeles County, California",Census Tract 2291,1101,480,621,464300
06037229200,"Census Tract 2292, Los Angeles County, California",Census Tract 2292,1205,210,995,364800
06037229300,"Census Tract 2293, Los Angeles County, California",Census Tract 2293,1362,401,961,493600
06037229410,"Census Tract 2294.10, Los Angeles County, California",Census Tract 2294.10,878,207,671,429400
06037229420,"Census Tract 2294.20, Los Angeles County, California",Census Tract 2294.20,1029,302,727,435400
06037231100,"Census Tract 2311, Los Angeles County, California",Census Tract 2311,690,80,610,431800
06037231210,"Census Tract 2312.10, Los Angeles County, California",Census Tract 2312.10,1160,135,1025,464200
06037231220,"Census Tract 2312.20, Los Angeles County, California",Census Tract 2312.20,1437,152,1285,570900
06037231301,"Census Tract 2313.01, Los Angeles County, California",Census Tract 2313.01,836,247,589,470500
06037231302,"Census Tract 2313.02, Los Angeles County, California",Census Tract 2313.02,835,371,464,616200
06037231400,"Census Tract 2314, Los Angeles County, California",Census Tract 2314,1522,647,875,563000
06037231500,"Census Tract 2315, Los Angeles County, California",Census Tract 2315,1461,915,546,620000
06037231601,"Census Tract 2316.01, Los Angeles County, California",Census Tract 2316.01,743,306,437,579800
06037231602,"Census Tract 2316.02, Los Angeles County, California",Census Tract 2316.02,611,308,303,547900
06037231603,"Census Tract 2316.03, Los Angeles County, California",Census Tract 2316.03,756,124,632,647200
06037231710,"Census Tract 2317.10, Los Angeles County, California",Census Tract 2317.10,1250,71,1179,
06037231720,"Census Tract 2317.20, Los Angeles County, California",Census Tract 2317.20,1473,285,1188,395500
06037231800,"Census Tract 2318, Los Angeles County, California",Census Tract 2318,1446,220,1226,540100
06037231901,"Census Tract 2319.01, Los Angeles County, California",Census Tract 2319.01,747,268,479,443000
06037231902,"Census Tract 2319.02, Los Angeles County, California",Census Tract 2319.02,789,253,536,474700
06037232110,"Census Tract 2321.10, Los Angeles County, California",Census Tract 2321.10,829,200,629,405600
06037232120,"Census Tract 2321.20, Los Angeles County, California",Census Tract 2321.20,1502,331,1171,471200
06037232200,"Census Tract 2322, Los Angeles County, California",Census Tract 2322,882,357,525,505800
06037232300,"Census Tract 2323, Los Angeles County, California",Census Tract 2323,1181,709,472,494500
06037232401,"Census Tract 2324.01, Los Angeles County, California",Census Tract 2324.01,1109,473,636,541300
06037232402,"Census Tract 2324.02, Los Angeles County, California",Census Tract 2324.02,930,506,424,556100
06037232500,"Census Tract 2325, Los Angeles County, California",Census Tract 2325,1486,652,834,501600
06037232601,"Census Tract 2326.01, Los Angeles County, California",Census Tract 2326.01,556,245,311,437800
06037232602,"Census Tract 2326.02, Los Angeles County, California",Census Tract 2326.02,1308,538,770,562500
06037232701,"Census Tract 2327.01, Los Angeles County, California",Census Tract 2327.01,558,236,322,547000
06037232702,"Census Tract 2327.02, Los Angeles County, California",Census Tract 2327.02,1012,313,699,556300
06037232800,"Census Tract 2328, Los Angeles County, California",Census Tract 2328,927,278,649,496000
06037234001,"Census Tract 2340.01, Los Angeles County, California",Census Tract 2340.01,994,666,328,838400
06037234002,"Census Tract 2340.02, Los Angeles County, California",Census Tract 2340.02,1027,442,585,640600
06037234200,"Census Tract 2342, Los Angeles County, California",Census Tract 2342,1117,801,316,759400
06037234301,"Census Tract 2343.01, Los Angeles County, California",Census Tract 2343.01,913,271,642,838100
06037234302,"Census Tract 2343.02, Los Angeles County, California",Census Tract 2343.02,1341,203,1138,692700
06037234501,"Census Tract 2345.01, Los Angeles County, California",Census Tract 2345.01,822,602,220,596000
06037234502,"Census Tract 2345.02, Los Angeles County, California",Census Tract 2345.02,1129,409,720,657600
06037234600,"Census Tract 2346, Los Angeles County, California",Census Tract 2346,1630,1066,564,634800
06037234700,"Census Tract 2347, Los Angeles County, California",Census Tract 2347,1342,690,652,501000
06037234800,"Census Tract 2348, Los Angeles County, California",Census Tract 2348,1160,658,502,470400
06037234901,"Census Tract 2349.01, Los Angeles County, California",Census Tract 2349.01,1263,28,1235,
06037234902,"Census Tract 2349.02, Los Angeles County, California",Census Tract 2349.02,1935,254,1681,539200
06037235100,"Census Tract 2351, Los Angeles County, California",Census Tract 2351,1773,1351,422,790700
06037235201,"Census Tract 2352.01, Los Angeles County, California",Census Tract 2352.01,943,742,201,516900
06037235202,"Census Tract 2352.02, Los Angeles County, California",Census Tract 2352.02,1754,557,1197,562700
06037236001,"Census Tract 2360.01, Los Angeles County, California",Census Tract 2360.01,1973,1507,466,695900
06037236101,"Census Tract 2361.01, Los Angeles County, California",Census Tract 2361.01,1323,460,863,682900
06037236102,"Census Tract 2361.02, Los Angeles County, California",Census Tract 2361.02,1846,464,1382,452000
06037236203,"Census Tract 2362.03, Los Angeles County, California",Census Tract 2362.03,1448,56,1392,
06037236204,"Census Tract 2362.04, Los Angeles County, California",Census Tract 2362.04,1231,0,1231,
06037236205,"Census Tract 2362.05, Los Angeles County, California",Census Tract 2362.05,1325,15,1310,
06037236206,"Census Tract 2362.06, Los Angeles County, California",Census Tract 2362.06,1311,0,1311,
06037236400,"Census Tract 2364, Los Angeles County, California",Census Tract 2364,2089,1081,1008,929800
06037237101,"Census Tract 2371.01, Los Angeles County, California",Census Tract 2371.01,1000,320,680,602100
06037237102,"Census Tract 2371.02, Los Angeles County, California",Census Tract 2371.02,999,241,758,459200
06037237201,"Census Tract 2372.01, Los Angeles County, California",Census Tract 2372.01,1021,420,601,432700
06037237202,"Census Tract 2372.02, Los Angeles County, California",Census Tract 2372.02,1216,480,736,478400
06037237300,"Census Tract 2373, Los Angeles County, California",Census Tract 2373,1798,1083,715,486000
06037237401,"Census Tract 2374.01, Los Angeles County, California",Census Tract 2374.01,1055,621,434,435700
06037237402,"Census Tract 2374.02, Los Angeles County, California",Census Tract 2374.02,1033,597,436,450900
06037237500,"Census Tract 2375, Los Angeles County, California",Census Tract 2375,796,106,690,450900
06037237600,"Census Tract 2376, Los Angeles County, California",Census Tract 2376,1162,299,863,379200
06037237710,"Census Tract 2377.10, Los Angeles County, California",Census Tract 2377.10,1091,155,936,336100
06037237720,"Census Tract 2377.20, Los Angeles County, California",Census Tract 2377.20,912,164,748,370100
06037237800,"Census Tract 2378, Los Angeles County, California",Census Tract 2378,1221,756,465,476700
06037237900,"Census Tract 2379, Los Angeles County, California",Census Tract 2379,1382,895,487,521800
06037238000,"Census Tract 2380, Los Angeles County, California",Census Tract 2380,2311,1328,983,500000
06037238100,"Census Tract 2381, Los Angeles County, California",Census Tract 2381,2083,692,1391,571300
06037238200,"Census Tract 2382, Los Angeles County, California",Census Tract 2382,2057,778,1279,445400
06037238310,"Census Tract 2383.10, Los Angeles County, California",Census Tract 2383.10,1374,66,1308,427300
06037238320,"Census Tract 2383.20, Los Angeles County, California",Census Tract 2383.20,1095,74,1021,500000
06037238400,"Census Tract 2384, Los Angeles County, California",Census Tract 2384,1736,1187,549,575200
06037239201,"Census Tract 2392.01, Los Angeles County, California",Census Tract 2392.01,843,153,690,491700
06037239202,"Census Tract 2392.02, Los Angeles County, California",Census Tract 2392.02,1239,206,1033,592000
06037239310,"Census Tract 2393.10, Los Angeles County, California",Census Tract 2393.10,991,180,811,446400
06037239320,"Census Tract 2393.20, Los Angeles County, California",Census Tract 2393.20,804,280,524,567300
06037239330,"Census Tract 2393.30, Los Angeles County, California",Census Tract 2393.30,732,269,463,406500
06037239501,"Census Tract 2395.01, Los Angeles County, California",Census Tract 2395.01,978,300,678,372700
06037239502,"Census Tract 2395.02, Los Angeles County, California",Census Tract 2395.02,877,309,568,463100
06037239601,"Census Tract 2396.01, Los Angeles County, California",Census Tract 2396.01,898,293,605,435500
06037239602,"Census Tract 2396.02, Los Angeles County, California",Census Tract 2396.02,903,263,640,428700
06037239701,"Census Tract 2397.01, Los Angeles County, California",Census Tract 2397.01,1114,302,812,422200
06037239702,"Census Tract 2397.02, Los Angeles County, California",Census Tract 2397.02,1144,295,849,456300
06037239801,"Census Tract 2398.01, Los Angeles County, California",Census Tract 2398.01,949,359,590,440400
06037239802,"Census Tract 2398.02, Los Angeles County, California",Census Tract 2398.02,1322,372,950,477600
06037240010,"Census Tract 2400.10, Los Angeles County, California",Census Tract 2400.10,1021,252,769,391400
06037240020,"Census Tract 2400.20, Los Angeles County, California",Census Tract 2400.20,1274,584,690,425400
06037240200,"Census Tract 2402, Los Angeles County, California",Census Tract 2402,1461,494,967,370100
06037240301,"Census Tract 2403.01, Los Angeles County, California",Census Tract 2403.01,916,215,701,490700
06037240302,"Census Tract 2403.02, Los Angeles County, California",Census Tract 2403.02,719,157,562,633400
06037240401,"Census Tract 2404.01, Los Angeles County, California",Census Tract 2404.01,1578,358,1220,455600
06037240402,"Census Tract 2404.02, Los Angeles County, California",Census Tract 2404.02,1139,558,581,387800
06037240500,"Census Tract 2405, Los Angeles County, California",Census Tract 2405,1682,411,1271,437300
06037240600,"Census Tract 2406, Los Angeles County, California",Census Tract 2406,1220,350,870,418200
06037240700,"Census Tract 2407, Los Angeles County, California",Census Tract 2407,1664,788,876,417600
06037240800,"Census Tract 2408, Los Angeles County, California",Census Tract 2408,1113,542,571,404900
06037240901,"Census Tract 2409.01, Los Angeles County, California",Census Tract 2409.01,586,333,253,414400
06037240902,"Census Tract 2409.02, Los Angeles County, California",Census Tract 2409.02,805,341,464,368200
06037241001,"Census Tract 2410.01, Los Angeles County, California",Census Tract 2410.01,1086,468,618,443800
06037241002,"Census Tract 2410.02, Los Angeles County, California",Census Tract 2410.02,975,409,566,442600
06037241110,"Census Tract 2411.10, Los Angeles County, California",Census Tract 2411.10,809,323,486,438400
06037241120,"Census Tract 2411.20, Los Angeles County, California",Census Tract 2411.20,1312,365,947,415800
06037241201,"Census Tract 2412.01, Los Angeles County, California",Census Tract 2412.01,934,502,432,439700
06037241202,"Census Tract 2412.02, Los Angeles County, California",Census Tract 2412.02,1645,700,945,451900
06037241300,"Census Tract 2413, Los Angeles County, California",Census Tract 2413,726,298,428,470800
06037241400,"Census Tract 2414, Los Angeles County, California",Census Tract 2414,942,402,540,414900
06037242000,"Census Tract 2420, Los Angeles County, California",Census Tract 2420,1114,298,816,421300
06037242100,"Census Tract 2421, Los Angeles County, California",Census Tract 2421,734,1,733,
06037242201,"Census Tract 2422.01, Los Angeles County, California",Census Tract 2422.01,1010,367,643,400400
06037242202,"Census Tract 2422.02, Los Angeles County, California",Census Tract 2422.02,736,224,512,400000
06037242300,"Census Tract 2423, Los Angeles County, California",Census Tract 2423,1292,283,1009,426400
06037242600,"Census Tract 2426, Los Angeles County, California",Census Tract 2426,1342,120,1222,416700
06037242700,"Census Tract 2427, Los Angeles County, California",Census Tract 2427,1299,741,558,417700
06037243001,"Census Tract 2430.01, Los Angeles County, California",Census Tract 2430.01,758,422,336,381800
06037243002,"Census Tract 2430.02, Los Angeles County, California",Census Tract 2430.02,565,433,132,380900
06037243100,"Census Tract 2431, Los Angeles County, California",Census Tract 2431,1447,313,1134,363500
06037261102,"Census Tract 2611.02, Los Angeles County, California",Census Tract 2611.02,1428,1295,133,2000001
06037261103,"Census Tract 2611.03, Los Angeles County, California",Census Tract 2611.03,728,615,113,2000001
06037261104,"Census Tract 2611.04, Los Angeles County, California",Census Tract 2611.04,594,490,104,2000001
06037261200,"Census Tract 2612, Los Angeles County, California",Census Tract 2612,1596,1426,170,1705300
06037262100,"Census Tract 2621, Los Angeles County, California",Census Tract 2621,1012,902,110,2000001
06037262200,"Census Tract 2622, Los Angeles County, California",Census Tract 2622,1606,1177,429,2000001
06037262301,"Census Tract 2623.01, Los Angeles County, California",Census Tract 2623.01,786,730,56,2000001
06037262302,"Census Tract 2623.02, Los Angeles County, California",Census Tract 2623.02,1282,1024,258,2000001
06037262303,"Census Tract 2623.03, Los Angeles County, California",Census Tract 2623.03,1082,1054,28,2000001
06037262400,"Census Tract 2624, Los Angeles County, California",Census Tract 2624,1165,970,195,2000001
06037262501,"Census Tract 2625.01, Los Angeles County, California",Census Tract 2625.01,1285,1131,154,2000001
06037262601,"Census Tract 2626.01, Los Angeles County, California",Census Tract 2626.01,1287,1161,126,2000001
06037262604,"Census Tract 2626.04, Los Angeles County, California",Census Tract 2626.04,2118,1629,489,2000001
06037262704,"Census Tract 2627.04, Los Angeles County, California",Census Tract 2627.04,1507,961,546,2000001
06037262706,"Census Tract 2627.06, Los Angeles County, California",Census Tract 2627.06,1286,970,316,2000001
06037262802,"Census Tract 2628.02, Los Angeles County, California",Census Tract 2628.02,1330,1130,200,2000001
06037264000,"Census Tract 2640, Los Angeles County, California",Census Tract 2640,1252,1018,234,2000001
06037264102,"Census Tract 2641.02, Los Angeles County, California",Census Tract 2641.02,1585,543,1042,816800
06037264103,"Census Tract 2641.03, Los Angeles County, California",Census Tract 2641.03,1526,460,1066,808200
06037264303,"Census Tract 2643.03, Los Angeles County, California",Census Tract 2643.03,1450,350,1100,718100
06037264304,"Census Tract 2643.04, Los Angeles County, California",Census Tract 2643.04,1418,206,1212,1205900
06037264305,"Census Tract 2643.05, Los Angeles County, California",Census Tract 2643.05,1794,745,1049,2000001
06037264306,"Census Tract 2643.06, Los Angeles County, California",Census Tract 2643.06,898,341,557,1242400
06037265100,"Census Tract 2651, Los Angeles County, California",Census Tract 2651,1239,762,477,2000001
06037265201,"Census Tract 2652.01, Los Angeles County, California",Census Tract 2652.01,841,571,270,1555800
06037265203,"Census Tract 2652.03, Los Angeles County, California",Census Tract 2652.03,992,491,501,1154000
06037265204,"Census Tract 2652.04, Los Angeles County, California",Census Tract 2652.04,676,112,564,686700
06037265301,"Census Tract 2653.01, Los Angeles County, California",Census Tract 2653.01,0,0,0,
06037265303,"Census Tract 2653.03, Los Angeles County, California",Census Tract 2653.03,1457,59,1398,671500
06037265304,"Census Tract 2653.04, Los Angeles County, California",Census Tract 2653.04,843,0,843,
06037265306,"Census Tract 2653.06, Los Angeles County, California",Census Tract 2653.06,484,16,468,
06037265307,"Census Tract 2653.07, Los Angeles County, California",Census Tract 2653.07,1065,0,1065,
06037265410,"Census Tract 2654.10, Los Angeles County, California",Census Tract 2654.10,660,372,288,1842300
06037265420,"Census Tract 2654.20, Los Angeles County, California",Census Tract 2654.20,601,400,201,2000001
06037265521,"Census Tract 2655.21, Los Angeles County, California",Census Tract 2655.21,998,86,912,
06037265522,"Census Tract 2655.22, Los Angeles County, California",Census Tract 2655.22,968,139,829,687500
06037265523,"Census Tract 2655.23, Los Angeles County, California",Census Tract 2655.23,1362,542,820,886900
06037265524,"Census Tract 2655.24, Los Angeles County, California",Census Tract 2655.24,1318,328,990,846200
06037265601,"Census Tract 2656.01, Los Angeles County, California",Census Tract 2656.01,1368,645,723,1402500
06037265602,"Census Tract 2656.02, Los Angeles County, California",Census Tract 2656.02,1490,973,517,1204900
06037265701,"Census Tract 2657.01, Los Angeles County, California",Census Tract 2657.01,714,305,409,2000001
06037265702,"Census Tract 2657.02, Los Angeles County, California",Census Tract 2657.02,1415,724,691,1633000
06037267101,"Census Tract 2671.01, Los Angeles County, California",Census Tract 2671.01,1340,625,715,906400
06037267102,"Census Tract 2671.02, Los Angeles County, California",Census Tract 2671.02,1437,609,828,967100
06037267201,"Census Tract 2672.01, Los Angeles County, California",Census Tract 2672.01,1347,362,985,977600
06037267202,"Census Tract 2672.02, Los Angeles County, California",Census Tract 2672.02,1607,605,1002,1199000
06037267300,"Census Tract 2673, Los Angeles County, California",Census Tract 2673,2060,248,1812,548000
06037267403,"Census Tract 2674.03, Los Angeles County, California",Census Tract 2674.03,1828,202,1626,728700
06037267404,"Census Tract 2674.04, Los Angeles County, California",Census Tract 2674.04,1459,302,1157,941000
06037267405,"Census Tract 2674.05, Los Angeles County, California",Census Tract 2674.05,1438,131,1307,804900
06037267406,"Census Tract 2674.06, Los Angeles County, California",Census Tract 2674.06,1027,270,757,662500
06037267502,"Census Tract 2675.02, Los Angeles County, California",Census Tract 2675.02,1613,455,1158,1123000
06037267503,"Census Tract 2675.03, Los Angeles County, California",Census Tract 2675.03,1172,194,978,947700
06037267504,"Census Tract 2675.04, Los Angeles County, California",Census Tract 2675.04,1724,282,1442,784500
06037267600,"Census Tract 2676, Los Angeles County, California",Census Tract 2676,1258,487,771,962900
06037267700,"Census Tract 2677, Los Angeles County, California",Census Tract 2677,1735,514,1221,883900
06037267800,"Census Tract 2678, Los Angeles County, California",Census Tract 2678,1405,776,629,1193300
06037267901,"Census Tract 2679.01, Los Angeles County, California",Census Tract 2679.01,1518,1121,397,1344900
06037267902,"Census Tract 2679.02, Los Angeles County, California",Census Tract 2679.02,1696,710,986,1207100
06037269000,"Census Tract 2690, Los Angeles County, California",Census Tract 2690,2017,1361,656,2000001
06037269100,"Census Tract 2691, Los Angeles County, California",Census Tract 2691,1609,482,1127,1826100
06037269300,"Census Tract 2693, Los Angeles County, California",Census Tract 2693,1403,1165,238,2000001
06037269500,"Census Tract 2695, Los Angeles County, California",Census Tract 2695,1287,1176,111,2000001
06037269601,"Census Tract 2696.01, Los Angeles County, California",Census Tract 2696.01,1017,199,818,769500
06037269602,"Census Tract 2696.02, Los Angeles County, California",Census Tract 2696.02,950,147,803,1216500
06037269700,"Census Tract 2697, Los Angeles County, California",Census Tract 2697,1514,739,775,1096400
06037269800,"Census Tract 2698, Los Angeles County, California",Census Tract 2698,1487,304,1183,903800
06037269903,"Census Tract 2699.03, Los Angeles County, California",Census Tract 2699.03,1652,98,1554,944400
06037269905,"Census Tract 2699.05, Los Angeles County, California",Census Tract 2699.05,1289,12,1277,
06037269906,"Census Tract 2699.06, Los Angeles County, California",Census Tract 2699.06,1562,73,1489,745500
06037269907,"Census Tract 2699.07, Los Angeles County, California",Census Tract 2699.07,1280,78,1202,767900
06037269908,"Census Tract 2699.08, Los Angeles County, California",Census Tract 2699.08,1330,94,1236,
06037269909,"Census Tract 2699.09, Los Angeles County, California",Census Tract 2699.09,1245,35,1210,940200
06037270101,"Census Tract 2701.01, Los Angeles County, California",Census Tract 2701.01,1178,242,936,281600
06037270102,"Census Tract 2701.02, Los Angeles County, California",Census Tract 2701.02,1092,97,995,886700
06037270200,"Census Tract 2702, Los Angeles County, California",Census Tract 2702,1328,385,943,1094000
06037270300,"Census Tract 2703, Los Angeles County, California",Census Tract 2703,1094,711,383,1158900
06037271100,"Census Tract 2711, Los Angeles County, California",Census Tract 2711,872,524,348,1263600
06037271200,"Census Tract 2712, Los Angeles County, California",Census Tract 2712,1126,115,1011,834500
06037271300,"Census Tract 2713, Los Angeles County, California",Census Tract 2713,2014,1287,727,1168900
06037271400,"Census Tract 2714, Los Angeles County, California",Census Tract 2714,1360,1177,183,1492900
06037271500,"Census Tract 2715, Los Angeles County, California",Census Tract 2715,1256,680,576,1872500
06037271600,"Census Tract 2716, Los Angeles County, California",Census Tract 2716,2004,648,1356,1593100
06037271702,"Census Tract 2717.02, Los Angeles County, California",Census Tract 2717.02,1813,430,1383,1158700
06037271703,"Census Tract 2717.03, Los Angeles County, California",Census Tract 2717.03,1275,444,831,1334900
06037271704,"Census Tract 2717.04, Los Angeles County, California",Census Tract 2717.04,1254,257,997,1319900
06037271801,"Census Tract 2718.01, Los Angeles County, California",Census Tract 2718.01,1615,195,1420,1154300
06037271803,"Census Tract 2718.03, Los Angeles County, California",Census Tract 2718.03,1476,98,1378,661800
06037271804,"Census Tract 2718.04, Los Angeles County, California",Census Tract 2718.04,988,273,715,1222800
06037271901,"Census Tract 2719.01, Los Angeles County, California",Census Tract 2719.01,1435,476,959,1512000
06037271902,"Census Tract 2719.02, Los Angeles County, California",Census Tract 2719.02,1842,529,1313,1653500
06037272100,"Census Tract 2721, Los Angeles County, California",Census Tract 2721,1865,1136,729,1415600
06037272201,"Census Tract 2722.01, Los Angeles County, California",Census Tract 2722.01,1026,181,845,1132500
06037272202,"Census Tract 2722.02, Los Angeles County, California",Census Tract 2722.02,1625,317,1308,920500
06037272301,"Census Tract 2723.01, Los Angeles County, California",Census Tract 2723.01,1407,499,908,1279300
06037272302,"Census Tract 2723.02, Los Angeles County, California",Census Tract 2723.02,1772,200,1572,745900
06037273100,"Census Tract 2731, Los Angeles County, California",Census Tract 2731,1178,568,610,1662300
06037273200,"Census Tract 2732, Los Angeles County, California",Census Tract 2732,1387,545,842,1681400
06037273300,"Census Tract 2733, Los Angeles County, California",Census Tract 2733,1411,271,1140,1835200
06037273403,"Census Tract 2734.03, Los Angeles County, California",Census Tract 2734.03,822,271,551,2000001
06037273404,"Census Tract 2734.04, Los Angeles County, California",Census Tract 2734.04,1023,259,764,1603300
06037273502,"Census Tract 2735.02, Los Angeles County, California",Census Tract 2735.02,1692,362,1330,1845000
06037273600,"Census Tract 2736, Los Angeles County, California",Census Tract 2736,1119,645,474,2000001
06037273700,"Census Tract 2737, Los Angeles County, California",Census Tract 2737,1249,586,663,1843400
06037273800,"Census Tract 2738, Los Angeles County, California",Census Tract 2738,1477,512,965,1594500
06037273902,"Census Tract 2739.02, Los Angeles County, California",Census Tract 2739.02,2189,1044,1145,2000001
06037274100,"Census Tract 2741, Los Angeles County, California",Census Tract 2741,2156,898,1258,1389500
06037274202,"Census Tract 2742.02, Los Angeles County, California",Census Tract 2742.02,2276,1183,1093,1588200
06037275101,"Census Tract 2751.01, Los Angeles County, California",Census Tract 2751.01,433,166,267,996000
06037275102,"Census Tract 2751.02, Los Angeles County, California",Census Tract 2751.02,1322,391,931,1202700
06037275200,"Census Tract 2752, Los Angeles County, California",Census Tract 2752,1637,362,1275,936500
06037275311,"Census Tract 2753.11, Los Angeles County, California",Census Tract 2753.11,2530,1089,1441,1009100
06037275312,"Census Tract 2753.12, Los Angeles County, California",Census Tract 2753.12,1001,469,532,912100
06037275313,"Census Tract 2753.13, Los Angeles County, California",Census Tract 2753.13,1641,1139,502,1071500
06037275400,"Census Tract 2754, Los Angeles County, California",Census Tract 2754,2317,1016,1301,1087500
06037275500,"Census Tract 2755, Los Angeles County, California",Census Tract 2755,1714,540,1174,782300
06037275603,"Census Tract 2756.03, Los Angeles County, California",Census Tract 2756.03,1214,701,513,933100
06037275604,"Census Tract 2756.04, Los Angeles County, California",Census Tract 2756.04,4597,1729,2868,1108900
06037275605,"Census Tract 2756.05, Los Angeles County, California",Census Tract 2756.05,1503,340,1163,1519000
06037276000,"Census Tract 2760, Los Angeles County, California",Census Tract 2760,2872,1634,1238,1088200
06037276101,"Census Tract 2761.01, Los Angeles County, California",Census Tract 2761.01,1569,173,1396,610500
06037276102,"Census Tract 2761.02, Los Angeles County, California",Census Tract 2761.02,1573,532,1041,952800
06037276400,"Census Tract 2764, Los Angeles County, California",Census Tract 2764,1434,1130,304,1295500
06037276500,"Census Tract 2765, Los Angeles County, California",Census Tract 2765,730,442,288,1044500
06037276601,"Census Tract 2766.01, Los Angeles County, California",Census Tract 2766.01,1623,944,679,1542400
06037276605,"Census Tract 2766.05, Los Angeles County, California",Census Tract 2766.05,1308,519,789,706900
06037276606,"Census Tract 2766.06, Los Angeles County, California",Census Tract 2766.06,1820,735,1085,666800
06037276607,"Census Tract 2766.07, Los Angeles County, California",Census Tract 2766.07,1410,433,977,1151400
06037276608,"Census Tract 2766.08, Los Angeles County, California",Census Tract 2766.08,1072,483,589,488700
06037277000,"Census Tract 2770, Los Angeles County, California",Census Tract 2770,2102,1514,588,1326300
06037277100,"Census Tract 2771, Los Angeles County, California",Census Tract 2771,1104,831,273,988100
06037277200,"Census Tract 2772, Los Angeles County, California",Census Tract 2772,922,227,695,450000
06037277400,"Census Tract 2774, Los Angeles County, California",Census Tract 2774,64,0,64,
06037278001,"Census Tract 2780.01, Los Angeles County, California",Census Tract 2780.01,1044,588,456,942200
06037278102,"Census Tract 2781.02, Los Angeles County, California",Census Tract 2781.02,1482,778,704,1645900
06037291110,"Census Tract 2911.10, Los Angeles County, California",Census Tract 2911.10,1351,257,1094,683900
06037291120,"Census Tract 2911.20, Los Angeles County, California",Census Tract 2911.20,641,193,448,491800
06037291130,"Census Tract 2911.30, Los Angeles County, California",Census Tract 2911.30,952,710,242,472600
06037291210,"Census Tract 2912.10, Los Angeles County, California",Census Tract 2912.10,1679,771,908,602200
06037291220,"Census Tract 2912.20, Los Angeles County, California",Census Tract 2912.20,1081,419,662,621500
06037291300,"Census Tract 2913, Los Angeles County, California",Census Tract 2913,1114,821,293,612600
06037292001,"Census Tract 2920.01, Los Angeles County, California",Census Tract 2920.01,1384,258,1126,635700
06037292002,"Census Tract 2920.02, Los Angeles County, California",Census Tract 2920.02,510,360,150,646600
06037293203,"Census Tract 2932.03, Los Angeles County, California",Census Tract 2932.03,1042,416,626,642600
06037293204,"Census Tract 2932.04, Los Angeles County, California",Census Tract 2932.04,1029,569,460,604900
06037293205,"Census Tract 2932.05, Los Angeles County, California",Census Tract 2932.05,989,210,779,451000
06037293206,"Census Tract 2932.06, Los Angeles County, California",Census Tract 2932.06,794,208,586,618200
06037293301,"Census Tract 2933.01, Los Angeles County, California",Census Tract 2933.01,940,592,348,601900
06037293302,"Census Tract 2933.02, Los Angeles County, California",Census Tract 2933.02,1645,1066,579,552400
06037293304,"Census Tract 2933.04, Los Angeles County, California",Census Tract 2933.04,1598,478,1120,590300
06037293306,"Census Tract 2933.06, Los Angeles County, California",Census Tract 2933.06,799,569,230,634200
06037293307,"Census Tract 2933.07, Los Angeles County, California",Census Tract 2933.07,899,235,664,429000
06037294110,"Census Tract 2941.10, Los Angeles County, California",Census Tract 2941.10,1050,619,431,526400
06037294120,"Census Tract 2941.20, Los Angeles County, California",Census Tract 2941.20,625,227,398,463000
06037294200,"Census Tract 2942, Los Angeles County, California",Census Tract 2942,1348,798,550,484000
06037294301,"Census Tract 2943.01, Los Angeles County, California",Census Tract 2943.01,658,497,161,501800
06037294302,"Census Tract 2943.02, Los Angeles County, California",Census Tract 2943.02,1248,605,643,424900
06037294410,"Census Tract 2944.10, Los Angeles County, California",Census Tract 2944.10,1574,616,958,374600
06037294421,"Census Tract 2944.21, Los Angeles County, California",Census Tract 2944.21,1001,408,593,410200
06037294510,"Census Tract 2945.10, Los Angeles County, California",Census Tract 2945.10,1184,448,736,542800
06037294520,"Census Tract 2945.20, Los Angeles County, California",Census Tract 2945.20,910,293,617,499500
06037294610,"Census Tract 2946.10, Los Angeles County, California",Census Tract 2946.10,1167,393,774,478700
06037294620,"Census Tract 2946.20, Los Angeles County, California",Census Tract 2946.20,1020,342,678,415200
06037294701,"Census Tract 2947.01, Los Angeles County, California",Census Tract 2947.01,945,224,721,466700
06037294810,"Census Tract 2948.10, Los Angeles County, California",Census Tract 2948.10,1044,136,908,505000
06037294820,"Census Tract 2948.20, Los Angeles County, California",Census Tract 2948.20,938,86,852,354500
06037294830,"Census Tract 2948.30, Los Angeles County, California",Census Tract 2948.30,1031,173,858,449300
06037294900,"Census Tract 2949, Los Angeles County, California",Census Tract 2949,981,290,691,443500
06037295103,"Census Tract 2951.03, Los Angeles County, California",Census Tract 2951.03,2059,1570,489,627300
06037296210,"Census Tract 2962.10, Los Angeles County, California",Census Tract 2962.10,1128,291,837,566300
06037296220,"Census Tract 2962.20, Los Angeles County, California",Census Tract 2962.20,1779,58,1721,380600
06037296300,"Census Tract 2963, Los Angeles County, California",Census Tract 2963,1866,1278,588,561300
06037296401,"Census Tract 2964.01, Los Angeles County, California",Census Tract 2964.01,1284,1114,170,646900
06037296402,"Census Tract 2964.02, Los Angeles County, California",Census Tract 2964.02,1145,893,252,634700
06037296500,"Census Tract 2965, Los Angeles County, California",Census Tract 2965,1214,439,775,541300
06037296600,"Census Tract 2966, Los Angeles County, California",Census Tract 2966,2107,353,1754,598800
06037296901,"Census Tract 2969.01, Los Angeles County, California",Census Tract 2969.01,1568,242,1326,710100
06037296902,"Census Tract 2969.02, Los Angeles County, California",Census Tract 2969.02,1569,352,1217,605300
06037297001,"Census Tract 2970.01, Los Angeles County, California",Census Tract 2970.01,622,455,167,821700
06037297002,"Census Tract 2970.02, Los Angeles County, California",Census Tract 2970.02,1700,822,878,811900
06037297110,"Census Tract 2971.10, Los Angeles County, California",Census Tract 2971.10,1569,238,1331,590600
06037297120,"Census Tract 2971.20, Los Angeles County, California",Census Tract 2971.20,1076,345,731,619800
06037297201,"Census Tract 2972.01, Los Angeles County, California",Census Tract 2972.01,1483,395,1088,536700
06037297202,"Census Tract 2972.02, Los Angeles County, California",Census Tract 2972.02,1556,648,908,683700
06037297300,"Census Tract 2973, Los Angeles County, California",Census Tract 2973,781,400,381,752200
06037297400,"Census Tract 2974, Los Angeles County, California",Census Tract 2974,1599,1421,178,828700
06037297501,"Census Tract 2975.01, Los Angeles County, California",Census Tract 2975.01,1033,884,149,757000
06037297502,"Census Tract 2975.02, Los Angeles County, California",Census Tract 2975.02,991,559,432,646000
06037297601,"Census Tract 2976.01, Los Angeles County, California",Census Tract 2976.01,1255,343,912,757400
06037297602,"Census Tract 2976.02, Los Angeles County, California",Census Tract 2976.02,1697,661,1036,636000
06037300100,"Census Tract 3001, Los Angeles County, California",Census Tract 3001,2102,1826,276,1091500
06037300200,"Census Tract 3002, Los Angeles County, California",Census Tract 3002,1827,1198,629,901800
06037300301,"Census Tract 3003.01, Los Angeles County, California",Census Tract 3003.01,2024,1762,262,854500
06037300400,"Census Tract 3004, Los Angeles County, California",Census Tract 3004,1904,1382,522,758800
06037300501,"Census Tract 3005.01, Los Angeles County, California",Census Tract 3005.01,1025,666,359,739900
06037300503,"Census Tract 3005.03, Los Angeles County, California",Census Tract 3005.03,2213,576,1637,738600
06037300601,"Census Tract 3006.01, Los Angeles County, California",Census Tract 3006.01,2126,942,1184,568500
06037300602,"Census Tract 3006.02, Los Angeles County, California",Census Tract 3006.02,1346,688,658,921000
06037300701,"Census Tract 3007.01, Los Angeles County, California",Census Tract 3007.01,2021,1736,285,1191300
06037300702,"Census Tract 3007.02, Los Angeles County, California",Census Tract 3007.02,2087,1852,235,1167300
06037300800,"Census Tract 3008, Los Angeles County, California",Census Tract 3008,2744,1178,1566,948000
06037300901,"Census Tract 3009.01, Los Angeles County, California",Census Tract 3009.01,2050,1746,304,1165500
06037300902,"Census Tract 3009.02, Los Angeles County, California",Census Tract 3009.02,762,679,83,1068900
06037301000,"Census Tract 3010, Los Angeles County, California",Census Tract 3010,2018,888,1130,973700
06037301100,"Census Tract 3011, Los Angeles County, California",Census Tract 3011,2840,1211,1629,921200
06037301203,"Census Tract 3012.03, Los Angeles County, California",Census Tract 3012.03,1822,717,1105,581800
06037301204,"Census Tract 3012.04, Los Angeles County, California",Census Tract 3012.04,2169,324,1845,570000
06037301205,"Census Tract 3012.05, Los Angeles County, California",Census Tract 3012.05,713,549,164,908300
06037301206,"Census Tract 3012.06, Los Angeles County, California",Census Tract 3012.06,1786,419,1367,881600
06037301300,"Census Tract 3013, Los Angeles County, California",Census Tract 3013,682,632,50,1361100
06037301400,"Census Tract 3014, Los Angeles County, California",Census Tract 3014,1251,1077,174,1099000
06037301501,"Census Tract 3015.01, Los Angeles County, California",Census Tract 3015.01,570,456,114,907800
06037301502,"Census Tract 3015.02, Los Angeles County, California",Census Tract 3015.02,2394,171,2223,631300
06037301601,"Census Tract 3016.01, Los Angeles County, California",Census Tract 3016.01,2274,200,2074,804700
06037301602,"Census Tract 3016.02, Los Angeles County, California",Census Tract 3016.02,1599,448,1151,795700
06037301701,"Census Tract 3017.01, Los Angeles County, California",Census Tract 3017.01,1014,486,528,745700
06037301702,"Census Tract 3017.02, Los Angeles County, California",Census Tract 3017.02,2133,423,1710,622500
06037301801,"Census Tract 3018.01, Los Angeles County, California",Census Tract 3018.01,2402,426,1976,547700
06037301802,"Census Tract 3018.02, Los Angeles County, California",Census Tract 3018.02,2279,345,1934,569500
06037301901,"Census Tract 3019.01, Los Angeles County, California",Census Tract 3019.01,1826,620,1206,583300
06037301902,"Census Tract 3019.02, Los Angeles County, California",Census Tract 3019.02,1017,240,777,733700
06037302002,"Census Tract 3020.02, Los Angeles County, California",Census Tract 3020.02,1761,332,1429,557000
06037302003,"Census Tract 3020.03, Los Angeles County, California",Census Tract 3020.03,1497,173,1324,547700
06037302004,"Census Tract 3020.04, Los Angeles County, California",Census Tract 3020.04,1557,191,1366,482900
06037302102,"Census Tract 3021.02, Los Angeles County, California",Census Tract 3021.02,2318,694,1624,801600
06037302103,"Census Tract 3021.03, Los Angeles County, California",Census Tract 3021.03,1853,205,1648,852800
06037302104,"Census Tract 3021.04, Los Angeles County, California",Census Tract 3021.04,1384,194,1190,674100
06037302201,"Census Tract 3022.01, Los Angeles County, California",Census Tract 3022.01,1784,109,1675,589300
06037302202,"Census Tract 3022.02, Los Angeles County, California",Census Tract 3022.02,1960,130,1830,533300
06037302301,"Census Tract 3023.01, Los Angeles County, California",Census Tract 3023.01,1325,304,1021,484600
06037302302,"Census Tract 3023.02, Los Angeles County, California",Census Tract 3023.02,1885,114,1771,827800
06037302401,"Census Tract 3024.01, Los Angeles County, California",Census Tract 3024.01,2692,109,2583,589900
06037302503,"Census Tract 3025.03, Los Angeles County, California",Census Tract 3025.03,1443,117,1326,635800
06037302504,"Census Tract 3025.04, Los Angeles County, California",Census Tract 3025.04,1371,195,1176,462400
06037302505,"Census Tract 3025.05, Los Angeles County, California",Census Tract 3025.05,1481,52,1429,705900
06037302506,"Census Tract 3025.06, Los Angeles County, California",Census Tract 3025.06,1230,301,929,753300
06037310100,"Census Tract 3101, Los Angeles County, California",Census Tract 3101,2000,1888,112,1027600
06037310201,"Census Tract 3102.01, Los Angeles County, California",Census Tract 3102.01,2050,1103,947,788400
06037310202,"Census Tract 3102.02, Los Angeles County, California",Census Tract 3102.02,1890,775,1115,944400
06037310300,"Census Tract 3103, Los Angeles County, California",Census Tract 3103,1131,1005,126,907300
06037310400,"Census Tract 3104, Los Angeles County, California",Census Tract 3104,1249,706,543,834900
06037310501,"Census Tract 3105.01, Los Angeles County, California",Census Tract 3105.01,1599,235,1364,698900
06037310601,"Census Tract 3106.01, Los Angeles County, California",Census Tract 3106.01,2436,580,1856,612900
06037310602,"Census Tract 3106.02, Los Angeles County, California",Census Tract 3106.02,1151,545,606,830800
06037310701,"Census Tract 3107.01, Los Angeles County, California",Census Tract 3107.01,1141,78,1063,618600
06037310703,"Census Tract 3107.03, Los Angeles County, California",Census Tract 3107.03,1903,231,1672,695000
06037310704,"Census Tract 3107.04, Los Angeles County, California",Census Tract 3107.04,2225,262,1963,572000
06037310705,"Census Tract 3107.05, Los Angeles County, California",Census Tract 3107.05,1368,102,1266,513900
06037310800,"Census Tract 3108, Los Angeles County, California",Census Tract 3108,2327,1161,1166,840200
06037310900,"Census Tract 3109, Los Angeles County, California",Census Tract 3109,2495,1733,762,768700
06037311000,"Census Tract 3110, Los Angeles County, California",Census Tract 3110,1493,886,607,731800
06037311100,"Census Tract 3111, Los Angeles County, California",Census Tract 3111,1524,928,596,762000
06037311200,"Census Tract 3112, Los Angeles County, California",Census Tract 3112,1348,601,747,747700
06037311300,"Census Tract 3113, Los Angeles County, California",Census Tract 3113,1639,1081,558,787200
06037311400,"Census Tract 3114, Los Angeles County, California",Census Tract 3114,986,634,352,931300
06037311500,"Census Tract 3115, Los Angeles County, California",Census Tract 3115,2365,1106,1259,884900
06037311601,"Census Tract 3116.01, Los Angeles County, California",Census Tract 3116.01,865,280,585,1469200
06037311602,"Census Tract 3116.02, Los Angeles County, California",Census Tract 3116.02,2420,400,2020,783700
06037311700,"Census Tract 3117, Los Angeles County, California",Census Tract 3117,2783,1586,1197,911600
06037311801,"Census Tract 3118.01, Los Angeles County, California",Census Tract 3118.01,1334,265,1069,769100
06037311802,"Census Tract 3118.02, Los Angeles County, California",Census Tract 3118.02,1635,404,1231,821000
06037320101,"Census Tract 3201.01, Los Angeles County, California",Census Tract 3201.01,1008,812,196,481400
06037320102,"Census Tract 3201.02, Los Angeles County, California",Census Tract 3201.02,917,688,229,569000
06037320201,"Census Tract 3202.01, Los Angeles County, California",Census Tract 3202.01,1144,202,942,441700
06037320202,"Census Tract 3202.02, Los Angeles County, California",Census Tract 3202.02,1412,988,424,555900
06037320300,"Census Tract 3203, Los Angeles County, California",Census Tract 3203,1936,1147,789,513500
06037400205,"Census Tract 4002.05, Los Angeles County, California",Census Tract 4002.05,839,767,72,1395100
06037400206,"Census Tract 4002.06, Los Angeles County, California",Census Tract 4002.06,1781,1634,147,840500
06037400207,"Census Tract 4002.07, Los Angeles County, California",Census Tract 4002.07,1474,1357,117,755000
06037400208,"Census Tract 4002.08, Los Angeles County, California",Census Tract 4002.08,490,416,74,814100
06037400209,"Census Tract 4002.09, Los Angeles County, California",Census Tract 4002.09,1620,1519,101,856100
06037400304,"Census Tract 4003.04, Los Angeles County, California",Census Tract 4003.04,2777,1363,1414,574100
06037400402,"Census Tract 4004.02, Los Angeles County, California",Census Tract 4004.02,1328,945,383,780100
06037400403,"Census Tract 4004.03, Los Angeles County, California",Census Tract 4004.03,1386,877,509,674500
06037400404,"Census Tract 4004.04, Los Angeles County, California",Census Tract 4004.04,1394,1314,80,886500
06037400501,"Census Tract 4005.01, Los Angeles County, California",Census Tract 4005.01,683,642,41,968500
06037400602,"Census Tract 4006.02, Los Angeles County, California",Census Tract 4006.02,1356,658,698,536600
06037400603,"Census Tract 4006.03, Los Angeles County, California",Census Tract 4006.03,1744,1054,690,484300
06037400605,"Census Tract 4006.05, Los Angeles County, California",Census Tract 4006.05,2221,1768,453,566300
06037400801,"Census Tract 4008.01, Los Angeles County, California",Census Tract 4008.01,1941,1558,383,658900
06037401001,"Census Tract 4010.01, Los Angeles County, California",Census Tract 4010.01,966,835,131,691300
06037401002,"Census Tract 4010.02, Los Angeles County, California",Census Tract 4010.02,1615,667,948,740200
06037401101,"Census Tract 4011.01, Los Angeles County, California",Census Tract 4011.01,1903,837,1066,652400
06037401102,"Census Tract 4011.02, Los Angeles County, California",Census Tract 4011.02,1299,558,741,583500
06037401201,"Census Tract 4012.01, Los Angeles County, California",Census Tract 4012.01,1055,911,144,681500
06037401202,"Census Tract 4012.02, Los Angeles County, California",Census Tract 4012.02,1361,1120,241,589200
06037401203,"Census Tract 4012.03, Los Angeles County, California",Census Tract 4012.03,1599,1159,440,592700
06037401303,"Census Tract 4013.03, Los Angeles County, California",Census Tract 4013.03,783,644,139,856000
06037401304,"Census Tract 4013.04, Los Angeles County, California",Census Tract 4013.04,1850,1745,105,786100
06037401311,"Census Tract 4013.11, Los Angeles County, California",Census Tract 4013.11,2299,1604,695,582500
06037401312,"Census Tract 4013.12, Los Angeles County, California",Census Tract 4013.12,1802,1410,392,234900
06037401500,"Census Tract 4015, Los Angeles County, California",Census Tract 4015,1779,1194,585,531600
06037401601,"Census Tract 4016.01, Los Angeles County, California",Census Tract 4016.01,2301,1577,724,323600
06037401602,"Census Tract 4016.02, Los Angeles County, California",Census Tract 4016.02,2190,1050,1140,574500
06037401705,"Census Tract 4017.05, Los Angeles County, California",Census Tract 4017.05,927,771,156,675900
06037401706,"Census Tract 4017.06, Los Angeles County, California",Census Tract 4017.06,1597,655,942,542100
06037401707,"Census Tract 4017.07, Los Angeles County, California",Census Tract 4017.07,2737,1538,1199,450900
06037401801,"Census Tract 4018.01, Los Angeles County, California",Census Tract 4018.01,1564,1269,295,666000
06037401802,"Census Tract 4018.02, Los Angeles County, California",Census Tract 4018.02,1351,1129,222,649200
06037401901,"Census Tract 4019.01, Los Angeles County, California",Census Tract 4019.01,97,4,93,
06037401902,"Census Tract 4019.02, Los Angeles County, California",Census Tract 4019.02,2935,1195,1740,816400
06037402001,"Census Tract 4020.01, Los Angeles County, California",Census Tract 4020.01,1354,749,605,591400
06037402002,"Census Tract 4020.02, Los Angeles County, California",Census Tract 4020.02,1619,881,738,577300
06037402101,"Census Tract 4021.01, Los Angeles County, California",Census Tract 4021.01,1070,734,336,431400
06037402102,"Census Tract 4021.02, Los Angeles County, California",Census Tract 4021.02,1290,911,379,466100
06037402200,"Census Tract 4022, Los Angeles County, California",Census Tract 4022,2125,1467,658,550000
06037402301,"Census Tract 4023.01, Los Angeles County, California",Census Tract 4023.01,1397,751,646,427700
06037402303,"Census Tract 4023.03, Los Angeles County, California",Census Tract 4023.03,1068,443,625,397600
06037402304,"Census Tract 4023.04, Los Angeles County, California",Census Tract 4023.04,1025,344,681,
06037402403,"Census Tract 4024.03, Los Angeles County, California",Census Tract 4024.03,1111,788,323,
06037402404,"Census Tract 4024.04, Los Angeles County, California",Census Tract 4024.04,4,0,4,
06037402405,"Census Tract 4024.05, Los Angeles County, California",Census Tract 4024.05,557,453,104,431800
06037402406,"Census Tract 4024.06, Los Angeles County, California",Census Tract 4024.06,1297,782,515,388900
06037402501,"Census Tract 4025.01, Los Angeles County, California",Census Tract 4025.01,1358,360,998,352700
06037402503,"Census Tract 4025.03, Los Angeles County, California",Census Tract 4025.03,1113,393,720,488400
06037402504,"Census Tract 4025.04, Los Angeles County, California",Census Tract 4025.04,785,292,493,458000
06037402601,"Census Tract 4026.01, Los Angeles County, California",Census Tract 4026.01,772,303,469,410800
06037402602,"Census Tract 4026.02, Los Angeles County, California",Census Tract 4026.02,1887,875,1012,556200
06037402702,"Census Tract 4027.02, Los Angeles County, California",Census Tract 4027.02,1425,311,1114,416500
06037402703,"Census Tract 4027.03, Los Angeles County, California",Census Tract 4027.03,1348,846,502,387100
06037402705,"Census Tract 4027.05, Los Angeles County, California",Census Tract 4027.05,896,723,173,443200
06037402706,"Census Tract 4027.06, Los Angeles County, California",Census Tract 4027.06,973,681,292,439200
06037402801,"Census Tract 4028.01, Los Angeles County, California",Census Tract 4028.01,1167,334,833,359800
06037402803,"Census Tract 4028.03, Los Angeles County, California",Census Tract 4028.03,730,302,428,395500
06037402804,"Census Tract 4028.04, Los Angeles County, California",Census Tract 4028.04,990,211,779,362700
06037402902,"Census Tract 4029.02, Los Angeles County, California",Census Tract 4029.02,1713,847,866,418200
06037402903,"Census Tract 4029.03, Los Angeles County, California",Census Tract 4029.03,959,518,441,434700
06037402904,"Census Tract 4029.04, Los Angeles County, California",Census Tract 4029.04,877,616,261,422500
06037403000,"Census Tract 4030, Los Angeles County, California",Census Tract 4030,1630,1174,456,388100
06037403305,"Census Tract 4033.05, Los Angeles County, California",Census Tract 4033.05,679,520,159,668000
06037403316,"Census Tract 4033.16, Los Angeles County, California",Census Tract 4033.16,2582,2033,549,557300
06037403317,"Census Tract 4033.17, Los Angeles County, California",Census Tract 4033.17,1670,1424,246,634100
06037403318,"Census Tract 4033.18, Los Angeles County, California",Census Tract 4033.18,2044,1655,389,579800
06037403319,"Census Tract 4033.19, Los Angeles County, California",Census Tract 4033.19,1666,1141,525,626900
06037403320,"Census Tract 4033.20, Los Angeles County, California",Census Tract 4033.20,1600,1421,179,853300
06037403321,"Census Tract 4033.21, Los Angeles County, California",Census Tract 4033.21,1733,1359,374,678500
06037403323,"Census Tract 4033.23, Los Angeles County, California",Census Tract 4033.23,1715,1229,486,761100
06037403324,"Census Tract 4033.24, Los Angeles County, California",Census Tract 4033.24,2190,1637,553,931000
06037403325,"Census Tract 4033.25, Los Angeles County, California",Census Tract 4033.25,1546,1222,324,788600
06037403326,"Census Tract 4033.26, Los Angeles County, California",Census Tract 4033.26,669,492,177,621100
06037403327,"Census Tract 4033.27, Los Angeles County, California",Census Tract 4033.27,827,719,108,607300
06037403328,"Census Tract 4033.28, Los Angeles County, California",Census Tract 4033.28,1719,1275,444,616200
06037403401,"Census Tract 4034.01, Los Angeles County, California",Census Tract 4034.01,1445,1099,346,727800
06037403402,"Census Tract 4034.02, Los Angeles County, California",Census Tract 4034.02,988,837,151,711500
06037403403,"Census Tract 4034.03, Los Angeles County, California",Census Tract 4034.03,1667,1465,202,940000
06037403404,"Census Tract 4034.04, Los Angeles County, California",Census Tract 4034.04,644,594,50,938400
06037403407,"Census Tract 4034.07, Los Angeles County, California",Census Tract 4034.07,650,616,34,1192200
06037403408,"Census Tract 4034.08, Los Angeles County, California",Census Tract 4034.08,1997,1727,270,749800
06037403409,"Census Tract 4034.09, Los Angeles County, California",Census Tract 4034.09,1272,903,369,778300
06037403500,"Census Tract 4035, Los Angeles County, California",Census Tract 4035,527,408,119,1031500
06037403601,"Census Tract 4036.01, Los Angeles County, California",Census Tract 4036.01,2194,1632,562,703600
06037403702,"Census Tract 4037.02, Los Angeles County, California",Census Tract 4037.02,1265,1085,180,644000
06037403703,"Census Tract 4037.03, Los Angeles County, California",Census Tract 4037.03,1488,1213,275,600900
06037403721,"Census Tract 4037.21, Los Angeles County, California",Census Tract 4037.21,1771,998,773,564800
06037403722,"Census Tract 4037.22, Los Angeles County, California",Census Tract 4037.22,1688,694,994,615300
06037403801,"Census Tract 4038.01, Los Angeles County, California",Census Tract 4038.01,2103,1139,964,484700
06037403802,"Census Tract 4038.02, Los Angeles County, California",Census Tract 4038.02,2164,1240,924,520200
06037403901,"Census Tract 4039.01, Los Angeles County, California",Census Tract 4039.01,895,664,231,523400
06037403902,"Census Tract 4039.02, Los Angeles County, California",Census Tract 4039.02,1519,1059,460,574000
06037404000,"Census Tract 4040, Los Angeles County, California",Census Tract 4040,1329,831,498,559700
06037404100,"Census Tract 4041, Los Angeles County, California",Census Tract 4041,1447,975,472,453500
06037404201,"Census Tract 4042.01, Los Angeles County, California",Census Tract 4042.01,944,495,449,464700
06037404203,"Census Tract 4042.03, Los Angeles County, California",Census Tract 4042.03,821,416,405,533100
06037404301,"Census Tract 4043.01, Los Angeles County, California",Census Tract 4043.01,1415,330,1085,456500
06037404302,"Census Tract 4043.02, Los Angeles County, California",Census Tract 4043.02,610,385,225,463600
06037404401,"Census Tract 4044.01, Los Angeles County, California",Census Tract 4044.01,1013,624,389,448100
06037404402,"Census Tract 4044.02, Los Angeles County, California",Census Tract 4044.02,1174,695,479,492900
06037404501,"Census Tract 4045.01, Los Angeles County, California",Census Tract 4045.01,716,406,310,402300
06037404503,"Census Tract 4045.03, Los Angeles County, California",Census Tract 4045.03,816,603,213,435500
06037404504,"Census Tract 4045.04, Los Angeles County, California",Census Tract 4045.04,1345,419,926,438400
06037404600,"Census Tract 4046, Los Angeles County, California",Census Tract 4046,416,341,75,503900
06037404701,"Census Tract 4047.01, Los Angeles County, California",Census Tract 4047.01,1287,835,452,446600
06037404702,"Census Tract 4047.02, Los Angeles County, California",Census Tract 4047.02,1359,742,617,450200
06037404703,"Census Tract 4047.03, Los Angeles County, California",Census Tract 4047.03,711,316,395,522400
06037404804,"Census Tract 4048.04, Los Angeles County, California",Census Tract 4048.04,1061,526,535,462500
06037404805,"Census Tract 4048.05, Los Angeles County, California",Census Tract 4048.05,728,305,423,486100
06037404806,"Census Tract 4048.06, Los Angeles County, California",Census Tract 4048.06,1495,852,643,444100
06037404901,"Census Tract 4049.01, Los Angeles County, California",Census Tract 4049.01,1331,829,502,522000
06037404902,"Census Tract 4049.02, Los Angeles County, California",Census Tract 4049.02,865,681,184,489800
06037404903,"Census Tract 4049.03, Los Angeles County, California",Census Tract 4049.03,618,406,212,458900
06037405001,"Census Tract 4050.01, Los Angeles County, California",Census Tract 4050.01,1329,1004,325,468400
06037405002,"Census Tract 4050.02, Los Angeles County, California",Census Tract 4050.02,707,496,211,442300
06037405101,"Census Tract 4051.01, Los Angeles County, California",Census Tract 4051.01,1239,770,469,437300
06037405102,"Census Tract 4051.02, Los Angeles County, California",Census Tract 4051.02,1390,747,643,424700
06037405201,"Census Tract 4052.01, Los Angeles County, California",Census Tract 4052.01,1398,799,599,490800
06037405202,"Census Tract 4052.02, Los Angeles County, California",Census Tract 4052.02,1144,571,573,548200
06037405203,"Census Tract 4052.03, Los Angeles County, California",Census Tract 4052.03,683,519,164,497900
06037405301,"Census Tract 4053.01, Los Angeles County, California",Census Tract 4053.01,957,449,508,515800
06037405302,"Census Tract 4053.02, Los Angeles County, California",Census Tract 4053.02,1579,901,678,583000
06037405400,"Census Tract 4054, Los Angeles County, California",Census Tract 4054,1250,966,284,485300
06037405500,"Census Tract 4055, Los Angeles County, California",Census Tract 4055,1854,1358,496,586400
06037405600,"Census Tract 4056, Los Angeles County, California",Census Tract 4056,1677,1169,508,604900
06037405701,"Census Tract 4057.01, Los Angeles County, California",Census Tract 4057.01,1104,766,338,474200
06037405702,"Census Tract 4057.02, Los Angeles County, California",Census Tract 4057.02,1562,1135,427,481400
06037405800,"Census Tract 4058, Los Angeles County, California",Census Tract 4058,1748,1155,593,478600
06037405900,"Census Tract 4059, Los Angeles County, California",Census Tract 4059,1302,940,362,520800
06037406000,"Census Tract 4060, Los Angeles County, California",Census Tract 4060,1505,1053,452,562600
06037406101,"Census Tract 4061.01, Los Angeles County, California",Census Tract 4061.01,1223,495,728,531700
06037406103,"Census Tract 4061.03, Los Angeles County, California",Census Tract 4061.03,2821,923,1898,590100
06037406201,"Census Tract 4062.01, Los Angeles County, California",Census Tract 4062.01,1258,367,891,604200
06037406300,"Census Tract 4063, Los Angeles County, California",Census Tract 4063,1845,1327,518,857800
06037406413,"Census Tract 4064.13, Los Angeles County, California",Census Tract 4064.13,2055,1622,433,645900
06037406500,"Census Tract 4065, Los Angeles County, California",Census Tract 4065,1917,1336,581,601000
06037406601,"Census Tract 4066.01, Los Angeles County, California",Census Tract 4066.01,1432,1170,262,595700
06037406602,"Census Tract 4066.02, Los Angeles County, California",Census Tract 4066.02,1274,954,320,575600
06037406701,"Census Tract 4067.01, Los Angeles County, California",Census Tract 4067.01,913,582,331,628000
06037406702,"Census Tract 4067.02, Los Angeles County, California",Census Tract 4067.02,1962,934,1028,584800
06037406801,"Census Tract 4068.01, Los Angeles County, California",Census Tract 4068.01,1277,1043,234,607600
06037406903,"Census Tract 4069.03, Los Angeles County, California",Census Tract 4069.03,2082,1465,617,474000
06037407001,"Census Tract 4070.01, Los Angeles County, California",Census Tract 4070.01,1238,1020,218,490700
06037407002,"Census Tract 4070.02, Los Angeles County, California",Census Tract 4070.02,699,627,72,461500
06037407101,"Census Tract 4071.01, Los Angeles County, California",Census Tract 4071.01,1114,596,518,436600
06037407102,"Census Tract 4071.02, Los Angeles County, California",Census Tract 4071.02,1300,942,358,522300
06037407201,"Census Tract 4072.01, Los Angeles County, California",Census Tract 4072.01,836,514,322,449100
06037407202,"Census Tract 4072.02, Los Angeles County, California",Census Tract 4072.02,761,589,172,511600
06037407301,"Census Tract 4073.01, Los Angeles County, California",Census Tract 4073.01,928,666,262,500900
06037407302,"Census Tract 4073.02, Los Angeles County, California",Census Tract 4073.02,817,642,175,447100
06037407400,"Census Tract 4074, Los Angeles County, California",Census Tract 4074,538,401,137,592800
06037407501,"Census Tract 4075.01, Los Angeles County, California",Census Tract 4075.01,981,539,442,509400
06037407502,"Census Tract 4075.02, Los Angeles County, California",Census Tract 4075.02,812,543,269,533900
06037407601,"Census Tract 4076.01, Los Angeles County, California",Census Tract 4076.01,1043,347,696,446600
06037407602,"Census Tract 4076.02, Los Angeles County, California",Census Tract 4076.02,1036,761,275,481600
06037407701,"Census Tract 4077.01, Los Angeles County, California",Census Tract 4077.01,1060,395,665,433700
06037407702,"Census Tract 4077.02, Los Angeles County, California",Census Tract 4077.02,1762,1335,427,464400
06037407801,"Census Tract 4078.01, Los Angeles County, California",Census Tract 4078.01,1014,768,246,460300
06037407802,"Census Tract 4078.02, Los Angeles County, California",Census Tract 4078.02,741,573,168,521000
06037407901,"Census Tract 4079.01, Los Angeles County, California",Census Tract 4079.01,885,673,212,513900
06037407902,"Census Tract 4079.02, Los Angeles County, California",Census Tract 4079.02,524,410,114,547400
06037408003,"Census Tract 4080.03, Los Angeles County, California",Census Tract 4080.03,1195,942,253,580000
06037408004,"Census Tract 4080.04, Los Angeles County, California",Census Tract 4080.04,835,429,406,437000
06037408005,"Census Tract 4080.05, Los Angeles County, California",Census Tract 4080.05,1673,1205,468,674100
06037408006,"Census Tract 4080.06, Los Angeles County, California",Census Tract 4080.06,1020,490,530,587100
06037408133,"Census Tract 4081.33, Los Angeles County, California",Census Tract 4081.33,1631,746,885,607300
06037408134,"Census Tract 4081.34, Los Angeles County, California",Census Tract 4081.34,845,659,186,550500
06037408135,"Census Tract 4081.35, Los Angeles County, California",Census Tract 4081.35,1331,732,599,577900
06037408136,"Census Tract 4081.36, Los Angeles County, California",Census Tract 4081.36,975,773,202,555800
06037408137,"Census Tract 4081.37, Los Angeles County, California",Census Tract 4081.37,1396,542,854,463300
06037408138,"Census Tract 4081.38, Los Angeles County, California",Census Tract 4081.38,1232,895,337,387500
06037408139,"Census Tract 4081.39, Los Angeles County, California",Census Tract 4081.39,860,668,192,482000
06037408140,"Census Tract 4081.40, Los Angeles County, California",Census Tract 4081.40,817,566,251,389200
06037408141,"Census Tract 4081.41, Los Angeles County, California",Census Tract 4081.41,974,704,270,436600
06037408212,"Census Tract 4082.12, Los Angeles County, California",Census Tract 4082.12,1392,1110,282,602700
06037408213,"Census Tract 4082.13, Los Angeles County, California",Census Tract 4082.13,1740,915,825,511500
06037408301,"Census Tract 4083.01, Los Angeles County, California",Census Tract 4083.01,1507,1011,496,506500
06037408302,"Census Tract 4083.02, Los Angeles County, California",Census Tract 4083.02,1032,784,248,566800
06037408303,"Census Tract 4083.03, Los Angeles County, California",Census Tract 4083.03,1258,1097,161,621400
06037408401,"Census Tract 4084.01, Los Angeles County, California",Census Tract 4084.01,1241,823,418,548600
06037408402,"Census Tract 4084.02, Los Angeles County, California",Census Tract 4084.02,1933,1724,209,672500
06037408503,"Census Tract 4085.03, Los Angeles County, California",Census Tract 4085.03,1976,1785,191,739000
06037408504,"Census Tract 4085.04, Los Angeles County, California",Census Tract 4085.04,1444,830,614,587400
06037408505,"Census Tract 4085.05, Los Angeles County, California",Census Tract 4085.05,713,552,161,763500
06037408623,"Census Tract 4086.23, Los Angeles County, California",Census Tract 4086.23,974,670,304,618900
06037408624,"Census Tract 4086.24, Los Angeles County, California",Census Tract 4086.24,1016,918,98,647500
06037408625,"Census Tract 4086.25, Los Angeles County, California",Census Tract 4086.25,1217,985,232,695300
06037408626,"Census Tract 4086.26, Los Angeles County, California",Census Tract 4086.26,1378,993,385,776500
06037408627,"Census Tract 4086.27, Los Angeles County, California",Census Tract 4086.27,859,760,99,754600
06037408628,"Census Tract 4086.28, Los Angeles County, California",Census Tract 4086.28,1831,1246,585,713800
06037408629,"Census Tract 4086.29, Los Angeles County, California",Census Tract 4086.29,899,784,115,696700
06037408631,"Census Tract 4086.31, Los Angeles County, California",Census Tract 4086.31,1472,1069,403,560800
06037408703,"Census Tract 4087.03, Los Angeles County, California",Census Tract 4087.03,1776,1665,111,982700
06037408705,"Census Tract 4087.05, Los Angeles County, California",Census Tract 4087.05,1851,1404,447,613500
06037408707,"Census Tract 4087.07, Los Angeles County, California",Census Tract 4087.07,2127,1931,196,836500
06037408722,"Census Tract 4087.22, Los Angeles County, California",Census Tract 4087.22,1241,1038,203,618800
06037408724,"Census Tract 4087.24, Los Angeles County, California",Census Tract 4087.24,1558,43,1515,642200
06037408725,"Census Tract 4087.25, Los Angeles County, California",Census Tract 4087.25,1918,1100,818,586600
06037408800,"Census Tract 4088, Los Angeles County, California",Census Tract 4088,1691,217,1474,431500
06037408900,"Census Tract 4089, Los Angeles County, California",Census Tract 4089,2381,1618,763,587300
06037409000,"Census Tract 4090, Los Angeles County, California",Census Tract 4090,2193,1068,1125,405900
06037409100,"Census Tract 4091, Los Angeles County, California",Census Tract 4091,1385,958,427,491000
06037430003,"Census Tract 4300.03, Los Angeles County, California",Census Tract 4300.03,1688,1565,123,688400
06037430004,"Census Tract 4300.04, Los Angeles County, California",Census Tract 4300.04,1049,748,301,510800
06037430005,"Census Tract 4300.05, Los Angeles County, California",Census Tract 4300.05,1339,869,470,508100
06037430101,"Census Tract 4301.01, Los Angeles County, California",Census Tract 4301.01,1897,830,1067,499200
06037430102,"Census Tract 4301.02, Los Angeles County, California",Census Tract 4301.02,1310,718,592,470400
06037430200,"Census Tract 4302, Los Angeles County, California",Census Tract 4302,428,238,190,1500000
06037430301,"Census Tract 4303.01, Los Angeles County, California",Census Tract 4303.01,1644,1271,373,927600
06037430302,"Census Tract 4303.02, Los Angeles County, California",Census Tract 4303.02,2189,1512,677,813700
06037430400,"Census Tract 4304, Los Angeles County, California",Census Tract 4304,1439,1213,226,1323700
06037430501,"Census Tract 4305.01, Los Angeles County, California",Census Tract 4305.01,1859,1345,514,1054400
06037430502,"Census Tract 4305.02, Los Angeles County, California",Census Tract 4305.02,3102,1512,1590,1043400
06037430600,"Census Tract 4306, Los Angeles County, California",Census Tract 4306,1400,1246,154,2000001
06037430701,"Census Tract 4307.01, Los Angeles County, California",Census Tract 4307.01,1835,1005,830,1343800
06037430721,"Census Tract 4307.21, Los Angeles County, California",Census Tract 4307.21,1278,745,533,934300
06037430723,"Census Tract 4307.23, Los Angeles County, California",Census Tract 4307.23,1873,730,1143,665900
06037430724,"Census Tract 4307.24, Los Angeles County, California",Census Tract 4307.24,1900,428,1472,631800
06037430801,"Census Tract 4308.01, Los Angeles County, California",Census Tract 4308.01,2213,1035,1178,822600
06037430802,"Census Tract 4308.02, Los Angeles County, California",Census Tract 4308.02,1309,1039,270,1231200
06037430803,"Census Tract 4308.03, Los Angeles County, California",Census Tract 4308.03,1833,1366,467,1151300
06037430901,"Census Tract 4309.01, Los Angeles County, California",Census Tract 4309.01,1552,496,1056,646600
06037430902,"Census Tract 4309.02, Los Angeles County, California",Census Tract 4309.02,1788,616,1172,618900
06037431002,"Census Tract 4310.02, Los Angeles County, California",Census Tract 4310.02,1208,733,475,672900
06037431003,"Census Tract 4310.03, Los Angeles County, California",Census Tract 4310.03,1493,454,1039,679800
06037431004,"Census Tract 4310.04, Los Angeles County, California",Census Tract 4310.04,1213,442,771,638500
06037431100,"Census Tract 4311, Los Angeles County, California",Census Tract 4311,2220,1006,1214,610300
06037431200,"Census Tract 4312, Los Angeles County, California",Census Tract 4312,1492,985,507,535800
06037431300,"Census Tract 4313, Los Angeles County, California",Census Tract 4313,848,554,294,677500
06037431400,"Census Tract 4314, Los Angeles County, California",Census Tract 4314,1284,902,382,729900
06037431501,"Census Tract 4315.01, Los Angeles County, California",Census Tract 4315.01,1563,894,669,569000
06037431502,"Census Tract 4315.02, Los Angeles County, California",Census Tract 4315.02,1397,900,497,683800
06037431600,"Census Tract 4316, Los Angeles County, California",Census Tract 4316,1338,1009,329,1211100
06037431701,"Census Tract 4317.01, Los Angeles County, California",Census Tract 4317.01,2051,1400,651,1600400
06037431800,"Census Tract 4318, Los Angeles County, California",Census Tract 4318,1793,995,798,810100
06037431900,"Census Tract 4319, Los Angeles County, California",Census Tract 4319,1361,569,792,911700
06037432001,"Census Tract 4320.01, Los Angeles County, California",Census Tract 4320.01,616,431,185,844800
06037432002,"Census Tract 4320.02, Los Angeles County, California",Census Tract 4320.02,1868,1061,807,805700
06037432101,"Census Tract 4321.01, Los Angeles County, California",Census Tract 4321.01,1404,1025,379,699000
06037432102,"Census Tract 4321.02, Los Angeles County, California",Census Tract 4321.02,1737,1414,323,779000
06037432201,"Census Tract 4322.01, Los Angeles County, California",Census Tract 4322.01,1328,782,546,651800
06037432202,"Census Tract 4322.02, Los Angeles County, California",Census Tract 4322.02,1069,596,473,623100
06037432300,"Census Tract 4323, Los Angeles County, California",Census Tract 4323,1092,606,486,544500
06037432401,"Census Tract 4324.01, Los Angeles County, California",Census Tract 4324.01,1000,401,599,620900
06037432402,"Census Tract 4324.02, Los Angeles County, California",Census Tract 4324.02,1530,485,1045,538600
06037432501,"Census Tract 4325.01, Los Angeles County, California",Census Tract 4325.01,1379,720,659,488600
06037432502,"Census Tract 4325.02, Los Angeles County, California",Census Tract 4325.02,901,632,269,568500
06037432601,"Census Tract 4326.01, Los Angeles County, California",Census Tract 4326.01,1826,843,983,559400
06037432602,"Census Tract 4326.02, Los Angeles County, California",Census Tract 4326.02,1093,631,462,577600
06037432700,"Census Tract 4327, Los Angeles County, California",Census Tract 4327,1416,663,753,502200
06037432801,"Census Tract 4328.01, Los Angeles County, California",Census Tract 4328.01,822,240,582,441400
06037432802,"Census Tract 4328.02, Los Angeles County, California",Census Tract 4328.02,1401,173,1228,443400
06037432901,"Census Tract 4329.01, Los Angeles County, California",Census Tract 4329.01,1129,529,600,608100
06037432902,"Census Tract 4329.02, Los Angeles County, California",Census Tract 4329.02,813,590,223,622400
06037433103,"Census Tract 4331.03, Los Angeles County, California",Census Tract 4331.03,1840,959,881,496900
06037433200,"Census Tract 4332, Los Angeles County, California",Census Tract 4332,1627,864,763,497000
06037433302,"Census Tract 4333.02, Los Angeles County, California",Census Tract 4333.02,457,82,375,586400
06037433304,"Census Tract 4333.04, Los Angeles County, California",Census Tract 4333.04,1108,246,862,549600
06037433305,"Census Tract 4333.05, Los Angeles County, California",Census Tract 4333.05,1256,194,1062,425000
06037433306,"Census Tract 4333.06, Los Angeles County, California",Census Tract 4333.06,827,363,464,531100
06037433307,"Census Tract 4333.07, Los Angeles County, California",Census Tract 4333.07,810,373,437,454600
06037433402,"Census Tract 4334.02, Los Angeles County, California",Census Tract 4334.02,1123,337,786,462500
06037433403,"Census Tract 4334.03, Los Angeles County, California",Census Tract 4334.03,1239,357,882,545500
06037433505,"Census Tract 4335.05, Los Angeles County, California",Census Tract 4335.05,1086,414,672,519900
06037433506,"Census Tract 4335.06, Los Angeles County, California",Census Tract 4335.06,1036,199,837,
06037433601,"Census Tract 4336.01, Los Angeles County, California",Census Tract 4336.01,1283,570,713,600200
06037433602,"Census Tract 4336.02, Los Angeles County, California",Census Tract 4336.02,786,416,370,539400
06037433803,"Census Tract 4338.03, Los Angeles County, California",Census Tract 4338.03,851,701,150,495400
06037433804,"Census Tract 4338.04, Los Angeles County, California",Census Tract 4338.04,1048,461,587,374300
06037433901,"Census Tract 4339.01, Los Angeles County, California",Census Tract 4339.01,1339,380,959,516100
06037433903,"Census Tract 4339.03, Los Angeles County, California",Census Tract 4339.03,1408,607,801,478200
06037434001,"Census Tract 4340.01, Los Angeles County, California",Census Tract 4340.01,972,659,313,397200
06037434003,"Census Tract 4340.03, Los Angeles County, California",Census Tract 4340.03,939,411,528,539300
06037434004,"Census Tract 4340.04, Los Angeles County, California",Census Tract 4340.04,705,443,262,577400
06037434100,"Census Tract 4341, Los Angeles County, California",Census Tract 4341,1544,855,689,478500
06037460001,"Census Tract 4600.01, Los Angeles County, California",Census Tract 4600.01,598,563,35,2000001
06037460002,"Census Tract 4600.02, Los Angeles County, California",Census Tract 4600.02,1042,901,141,927600
06037460101,"Census Tract 4601.01, Los Angeles County, California",Census Tract 4601.01,2341,2091,250,1128100
06037460200,"Census Tract 4602, Los Angeles County, California",Census Tract 4602,1775,1467,308,949500
06037460301,"Census Tract 4603.01, Los Angeles County, California",Census Tract 4603.01,1412,1153,259,908900
06037460302,"Census Tract 4603.02, Los Angeles County, California",Census Tract 4603.02,1592,1159,433,658900
06037460401,"Census Tract 4604.01, Los Angeles County, California",Census Tract 4604.01,349,193,156,792300
06037460501,"Census Tract 4605.01, Los Angeles County, California",Census Tract 4605.01,1716,1604,112,1701300
06037460502,"Census Tract 4605.02, Los Angeles County, California",Census Tract 4605.02,1455,1343,112,1538400
06037460601,"Census Tract 4606.01, Los Angeles County, California",Census Tract 4606.01,1748,1393,355,1551300
06037460700,"Census Tract 4607, Los Angeles County, California",Census Tract 4607,1525,1443,82,2000001
06037460800,"Census Tract 4608, Los Angeles County, California",Census Tract 4608,1131,1115,16,1961200
06037460900,"Census Tract 4609, Los Angeles County, California",Census Tract 4609,1910,1162,748,682400
06037461000,"Census Tract 4610, Los Angeles County, California",Census Tract 4610,1534,1118,416,685100
06037461100,"Census Tract 4611, Los Angeles County, California",Census Tract 4611,1792,1088,704,824800
06037461200,"Census Tract 4612, Los Angeles County, California",Census Tract 4612,1681,1440,241,992800
06037461300,"Census Tract 4613, Los Angeles County, California",Census Tract 4613,2439,1370,1069,835400
06037461400,"Census Tract 4614, Los Angeles County, California",Census Tract 4614,1199,477,722,705300
06037461501,"Census Tract 4615.01, Los Angeles County, California",Census Tract 4615.01,1282,686,596,714700
06037461502,"Census Tract 4615.02, Los Angeles County, California",Census Tract 4615.02,1783,853,930,660400
06037461600,"Census Tract 4616, Los Angeles County, California",Census Tract 4616,1739,555,1184,676700
06037461700,"Census Tract 4617, Los Angeles County, California",Census Tract 4617,626,523,103,946800
06037461901,"Census Tract 4619.01, Los Angeles County, California",Census Tract 4619.01,1662,244,1418,691100
06037461902,"Census Tract 4619.02, Los Angeles County, California",Census Tract 4619.02,1191,114,1077,820000
06037462001,"Census Tract 4620.01, Los Angeles County, California",Census Tract 4620.01,1259,289,970,705900
06037462002,"Census Tract 4620.02, Los Angeles County, California",Census Tract 4620.02,1113,194,919,701800
06037462100,"Census Tract 4621, Los Angeles County, California",Census Tract 4621,1797,686,1111,814400
06037462201,"Census Tract 4622.01, Los Angeles County, California",Census Tract 4622.01,1869,71,1798,899000
06037462202,"Census Tract 4622.02, Los Angeles County, California",Census Tract 4622.02,1490,299,1191,607900
06037462301,"Census Tract 4623.01, Los Angeles County, California",Census Tract 4623.01,1851,334,1517,690100
06037462302,"Census Tract 4623.02, Los Angeles County, California",Census Tract 4623.02,1564,301,1263,609700
06037462400,"Census Tract 4624, Los Angeles County, California",Census Tract 4624,1421,823,598,903800
06037462500,"Census Tract 4625, Los Angeles County, California",Census Tract 4625,2633,1859,774,886600
06037462600,"Census Tract 4626, Los Angeles County, California",Census Tract 4626,894,691,203,970900
06037462700,"Census Tract 4627, Los Angeles County, California",Census Tract 4627,2269,691,1578,775500
06037462800,"Census Tract 4628, Los Angeles County, California",Census Tract 4628,1042,416,626,941000
06037462900,"Census Tract 4629, Los Angeles County, California",Census Tract 4629,1446,1132,314,778800
06037463000,"Census Tract 4630, Los Angeles County, California",Census Tract 4630,1074,569,505,1168100
06037463103,"Census Tract 4631.03, Los Angeles County, California",Census Tract 4631.03,1977,1340,637,882600
06037463200,"Census Tract 4632, Los Angeles County, California",Census Tract 4632,1470,863,607,907000
06037463300,"Census Tract 4633, Los Angeles County, California",Census Tract 4633,843,502,341,1016700
06037463400,"Census Tract 4634, Los Angeles County, California",Census Tract 4634,2514,1115,1399,924500
06037463500,"Census Tract 4635, Los Angeles County, California",Census Tract 4635,2269,667,1602,634400
06037463601,"Census Tract 4636.01, Los Angeles County, California",Census Tract 4636.01,3270,613,2657,622600
06037463602,"Census Tract 4636.02, Los Angeles County, California",Census Tract 4636.02,3239,566,2673,519400
06037463700,"Census Tract 4637, Los Angeles County, California",Census Tract 4637,1588,590,998,1645600
06037463800,"Census Tract 4638, Los Angeles County, California",Census Tract 4638,1477,1324,153,1218000
06037463900,"Census Tract 4639, Los Angeles County, California",Census Tract 4639,1378,723,655,1058400
06037464000,"Census Tract 4640, Los Angeles County, California",Census Tract 4640,2464,1650,814,1136600
06037464101,"Census Tract 4641.01, Los Angeles County, California",Census Tract 4641.01,773,725,48,2000001
06037464102,"Census Tract 4641.02, Los Angeles County, California",Census Tract 4641.02,1198,905,293,2000001
06037464200,"Census Tract 4642, Los Angeles County, California",Census Tract 4642,1971,1692,279,1863700
06037480002,"Census Tract 4800.02, Los Angeles County, California",Census Tract 4800.02,1247,1088,159,938500
06037480011,"Census Tract 4800.11, Los Angeles County, California",Census Tract 4800.11,1753,697,1056,753900
06037480012,"Census Tract 4800.12, Los Angeles County, California",Census Tract 4800.12,1665,928,737,851900
06037480101,"Census Tract 4801.01, Los Angeles County, California",Census Tract 4801.01,1310,821,489,883100
06037480102,"Census Tract 4801.02, Los Angeles County, California",Census Tract 4801.02,1313,825,488,805400
06037480201,"Census Tract 4802.01, Los Angeles County, California",Census Tract 4802.01,1149,971,178,889900
06037480202,"Census Tract 4802.02, Los Angeles County, California",Census Tract 4802.02,960,716,244,890500
06037480302,"Census Tract 4803.02, Los Angeles County, California",Census Tract 4803.02,1730,647,1083,770500
06037480303,"Census Tract 4803.03, Los Angeles County, California",Census Tract 4803.03,1546,341,1205,606400
06037480304,"Census Tract 4803.04, Los Angeles County, California",Census Tract 4803.04,1824,297,1527,501800
06037480400,"Census Tract 4804, Los Angeles County, California",Census Tract 4804,2214,948,1266,873100
06037480500,"Census Tract 4805, Los Angeles County, California",Census Tract 4805,2161,1411,750,1431700
06037480601,"Census Tract 4806.01, Los Angeles County, California",Census Tract 4806.01,1612,355,1257,1022300
06037480602,"Census Tract 4806.02, Los Angeles County, California",Census Tract 4806.02,1689,702,987,1161500
06037480702,"Census Tract 4807.02, Los Angeles County, California",Census Tract 4807.02,1645,1187,458,1174300
06037480703,"Census Tract 4807.03, Los Angeles County, California",Census Tract 4807.03,1362,728,634,1125600
06037480704,"Census Tract 4807.04, Los Angeles County, California",Census Tract 4807.04,1876,543,1333,926000
06037480802,"Census Tract 4808.02, Los Angeles County, California",Census Tract 4808.02,1127,792,335,625700
06037480803,"Census Tract 4808.03, Los Angeles County, California",Census Tract 4808.03,1206,688,518,654500
06037480804,"Census Tract 4808.04, Los Angeles County, California",Census Tract 4808.04,1846,400,1446,620500
06037480901,"Census Tract 4809.01, Los Angeles County, California",Census Tract 4809.01,1667,349,1318,616900
06037480902,"Census Tract 4809.02, Los Angeles County, California",Census Tract 4809.02,1411,251,1160,535100
06037480903,"Census Tract 4809.03, Los Angeles County, California",Census Tract 4809.03,1041,370,671,661200
06037481001,"Census Tract 4810.01, Los Angeles County, California",Census Tract 4810.01,1705,531,1174,650500
06037481002,"Census Tract 4810.02, Los Angeles County, California",Census Tract 4810.02,2026,602,1424,624600
06037481101,"Census Tract 4811.01, Los Angeles County, California",Census Tract 4811.01,1407,298,1109,675000
06037481102,"Census Tract 4811.02, Los Angeles County, California",Census Tract 4811.02,1281,149,1132,583700
06037481103,"Census Tract 4811.03, Los Angeles County, California",Census Tract 4811.03,1705,937,768,768300
06037481201,"Census Tract 4812.01, Los Angeles County, California",Census Tract 4812.01,1285,605,680,667800
06037481203,"Census Tract 4812.03, Los Angeles County, California",Census Tract 4812.03,1958,906,1052,678700
06037481300,"Census Tract 4813, Los Angeles County, California",Census Tract 4813,848,516,332,641200
06037481401,"Census Tract 4814.01, Los Angeles County, California",Census Tract 4814.01,1599,689,910,655900
06037481403,"Census Tract 4814.03, Los Angeles County, California",Census Tract 4814.03,905,366,539,752900
06037481404,"Census Tract 4814.04, Los Angeles County, California",Census Tract 4814.04,1142,652,490,748300
06037481500,"Census Tract 4815, Los Angeles County, California",Census Tract 4815,1519,942,577,655700
06037481603,"Census Tract 4816.03, Los Angeles County, California",Census Tract 4816.03,1151,570,581,685500
06037481604,"Census Tract 4816.04, Los Angeles County, California",Census Tract 4816.04,1413,516,897,579600
06037481605,"Census Tract 4816.05, Los Angeles County, California",Census Tract 4816.05,1011,431,580,576400
06037481606,"Census Tract 4816.06, Los Angeles County, California",Census Tract 4816.06,1611,455,1156,642500
06037481711,"Census Tract 4817.11, Los Angeles County, California",Census Tract 4817.11,1325,289,1036,534800
06037481712,"Census Tract 4817.12, Los Angeles County, California",Census Tract 4817.12,1709,476,1233,665900
06037481713,"Census Tract 4817.13, Los Angeles County, California",Census Tract 4817.13,968,375,593,624500
06037481714,"Census Tract 4817.14, Los Angeles County, California",Census Tract 4817.14,952,252,700,508000
06037481800,"Census Tract 4818, Los Angeles County, California",Census Tract 4818,845,696,149,666900
06037481901,"Census Tract 4819.01, Los Angeles County, California",Census Tract 4819.01,2070,1433,637,667600
06037481902,"Census Tract 4819.02, Los Angeles County, California",Census Tract 4819.02,1094,591,503,659800
06037482001,"Census Tract 4820.01, Los Angeles County, California",Census Tract 4820.01,927,785,142,735700
06037482002,"Census Tract 4820.02, Los Angeles County, California",Census Tract 4820.02,2589,1452,1137,806300
06037482101,"Census Tract 4821.01, Los Angeles County, California",Census Tract 4821.01,1474,718,756,675100
06037482102,"Census Tract 4821.02, Los Angeles County, California",Census Tract 4821.02,1068,842,226,789300
06037482201,"Census Tract 4822.01, Los Angeles County, California",Census Tract 4822.01,1278,583,695,660200
06037482202,"Census Tract 4822.02, Los Angeles County, California",Census Tract 4822.02,1672,518,1154,607000
06037482301,"Census Tract 4823.01, Los Angeles County, California",Census Tract 4823.01,1335,639,696,711800
06037482303,"Census Tract 4823.03, Los Angeles County, California",Census Tract 4823.03,1405,491,914,630000
06037482304,"Census Tract 4823.04, Los Angeles County, California",Census Tract 4823.04,783,150,633,605400
06037482401,"Census Tract 4824.01, Los Angeles County, California",Census Tract 4824.01,954,371,583,680300
06037482403,"Census Tract 4824.03, Los Angeles County, California",Census Tract 4824.03,892,273,619,555900
06037482404,"Census Tract 4824.04, Los Angeles County, California",Census Tract 4824.04,1184,963,221,511000
06037482502,"Census Tract 4825.02, Los Angeles County, California",Census Tract 4825.02,831,351,480,612800
06037482503,"Census Tract 4825.03, Los Angeles County, California",Census Tract 4825.03,993,405,588,617700
06037482521,"Census Tract 4825.21, Los Angeles County, California",Census Tract 4825.21,1444,1053,391,538700
06037482522,"Census Tract 4825.22, Los Angeles County, California",Census Tract 4825.22,1541,1001,540,428500
06037482600,"Census Tract 4826, Los Angeles County, California",Census Tract 4826,2256,1537,719,672500
06037482701,"Census Tract 4827.01, Los Angeles County, California",Census Tract 4827.01,1331,699,632,622600
06037482702,"Census Tract 4827.02, Los Angeles County, California",Census Tract 4827.02,839,583,256,624700
06037482801,"Census Tract 4828.01, Los Angeles County, California",Census Tract 4828.01,1290,866,424,625400
06037500100,"Census Tract 5001, Los Angeles County, California",Census Tract 5001,1110,1077,33,936600
06037500202,"Census Tract 5002.02, Los Angeles County, California",Census Tract 5002.02,1495,1306,189,1011200
06037500203,"Census Tract 5002.03, Los Angeles County, California",Census Tract 5002.03,1243,1158,85,705600
06037500204,"Census Tract 5002.04, Los Angeles County, California",Census Tract 5002.04,956,856,100,896200
06037500300,"Census Tract 5003, Los Angeles County, California",Census Tract 5003,1136,1038,98,688800
06037500402,"Census Tract 5004.02, Los Angeles County, California",Census Tract 5004.02,1210,647,563,519600
06037500403,"Census Tract 5004.03, Los Angeles County, California",Census Tract 5004.03,1074,1008,66,469700
06037500404,"Census Tract 5004.04, Los Angeles County, California",Census Tract 5004.04,1213,934,279,490800
06037500500,"Census Tract 5005, Los Angeles County, California",Census Tract 5005,830,584,246,379000
06037500600,"Census Tract 5006, Los Angeles County, California",Census Tract 5006,1247,988,259,457200
06037500700,"Census Tract 5007, Los Angeles County, California",Census Tract 5007,1851,1399,452,483900
06037500800,"Census Tract 5008, Los Angeles County, California",Census Tract 5008,1331,985,346,498000
06037500900,"Census Tract 5009, Los Angeles County, California",Census Tract 5009,1851,810,1041,496900
06037501001,"Census Tract 5010.01, Los Angeles County, California",Census Tract 5010.01,734,449,285,480500
06037501002,"Census Tract 5010.02, Los Angeles County, California",Census Tract 5010.02,1364,1127,237,524400
06037501200,"Census Tract 5012, Los Angeles County, California",Census Tract 5012,1435,1011,424,577200
06037501301,"Census Tract 5013.01, Los Angeles County, California",Census Tract 5013.01,1080,830,250,614100
06037501302,"Census Tract 5013.02, Los Angeles County, California",Census Tract 5013.02,1573,809,764,625200
06037501400,"Census Tract 5014, Los Angeles County, California",Census Tract 5014,1211,360,851,588500
06037501501,"Census Tract 5015.01, Los Angeles County, California",Census Tract 5015.01,847,694,153,694900
06037501503,"Census Tract 5015.03, Los Angeles County, California",Census Tract 5015.03,1874,373,1501,625800
06037501504,"Census Tract 5015.04, Los Angeles County, California",Census Tract 5015.04,1475,162,1313,497300
06037501600,"Census Tract 5016, Los Angeles County, California",Census Tract 5016,2212,1380,832,802200
06037501700,"Census Tract 5017, Los Angeles County, California",Census Tract 5017,1326,890,436,634300
06037501802,"Census Tract 5018.02, Los Angeles County, California",Census Tract 5018.02,1231,685,546,625500
06037501803,"Census Tract 5018.03, Los Angeles County, California",Census Tract 5018.03,1421,231,1190,595900
06037501804,"Census Tract 5018.04, Los Angeles County, California",Census Tract 5018.04,761,163,598,445600
06037501900,"Census Tract 5019, Los Angeles County, California",Census Tract 5019,1289,1063,226,567400
06037502003,"Census Tract 5020.03, Los Angeles County, California",Census Tract 5020.03,709,387,322,483300
06037502004,"Census Tract 5020.04, Los Angeles County, California",Census Tract 5020.04,973,530,443,490400
06037502005,"Census Tract 5020.05, Los Angeles County, California",Census Tract 5020.05,1259,763,496,549100
06037502100,"Census Tract 5021, Los Angeles County, California",Census Tract 5021,1637,1154,483,486000
06037502200,"Census Tract 5022, Los Angeles County, California",Census Tract 5022,1898,1190,708,498100
06037502303,"Census Tract 5023.03, Los Angeles County, California",Census Tract 5023.03,2004,1318,686,513000
06037502401,"Census Tract 5024.01, Los Angeles County, California",Census Tract 5024.01,1351,893,458,522700
06037502402,"Census Tract 5024.02, Los Angeles County, California",Census Tract 5024.02,962,854,108,506900
06037502500,"Census Tract 5025, Los Angeles County, California",Census Tract 5025,1165,651,514,483000
06037502602,"Census Tract 5026.02, Los Angeles County, California",Census Tract 5026.02,1265,535,730,543100
06037502603,"Census Tract 5026.03, Los Angeles County, California",Census Tract 5026.03,788,685,103,549200
06037502604,"Census Tract 5026.04, Los Angeles County, California",Census Tract 5026.04,1130,1055,75,552800
06037502700,"Census Tract 5027, Los Angeles County, California",Census Tract 5027,1990,1470,520,471800
06037502801,"Census Tract 5028.01, Los Angeles County, California",Census Tract 5028.01,1806,1592,214,520500
06037502901,"Census Tract 5029.01, Los Angeles County, California",Census Tract 5029.01,1563,1290,273,519600
06037503000,"Census Tract 5030, Los Angeles County, California",Census Tract 5030,1460,618,842,528300
06037503103,"Census Tract 5031.03, Los Angeles County, California",Census Tract 5031.03,1289,948,341,478700
06037503104,"Census Tract 5031.04, Los Angeles County, California",Census Tract 5031.04,672,469,203,468000
06037503105,"Census Tract 5031.05, Los Angeles County, California",Census Tract 5031.05,934,559,375,536700
06037503106,"Census Tract 5031.06, Los Angeles County, California",Census Tract 5031.06,1176,753,423,575500
06037503201,"Census Tract 5032.01, Los Angeles County, California",Census Tract 5032.01,1015,979,36,600300
06037503202,"Census Tract 5032.02, Los Angeles County, California",Census Tract 5032.02,1318,874,444,546800
06037503301,"Census Tract 5033.01, Los Angeles County, California",Census Tract 5033.01,1099,916,183,600500
06037503302,"Census Tract 5033.02, Los Angeles County, California",Census Tract 5033.02,1824,900,924,584300
06037503401,"Census Tract 5034.01, Los Angeles County, California",Census Tract 5034.01,2209,1628,581,607500
06037503402,"Census Tract 5034.02, Los Angeles County, California",Census Tract 5034.02,1294,1002,292,621600
06037503501,"Census Tract 5035.01, Los Angeles County, California",Census Tract 5035.01,1943,1239,704,577900
06037503502,"Census Tract 5035.02, Los Angeles County, California",Census Tract 5035.02,1114,880,234,564200
06037503601,"Census Tract 5036.01, Los Angeles County, California",Census Tract 5036.01,1209,978,231,614400
06037503602,"Census Tract 5036.02, Los Angeles County, California",Census Tract 5036.02,1149,1068,81,816100
06037503701,"Census Tract 5037.01, Los Angeles County, California",Census Tract 5037.01,1629,944,685,625800
06037503702,"Census Tract 5037.02, Los Angeles County, California",Census Tract 5037.02,1717,1089,628,626300
06037503704,"Census Tract 5037.04, Los Angeles County, California",Census Tract 5037.04,1952,1421,531,663000
06037503705,"Census Tract 5037.05, Los Angeles County, California",Census Tract 5037.05,1080,759,321,717600
06037503801,"Census Tract 5038.01, Los Angeles County, California",Census Tract 5038.01,1186,852,334,621900
06037503802,"Census Tract 5038.02, Los Angeles County, California",Census Tract 5038.02,1693,1373,320,616300
06037503901,"Census Tract 5039.01, Los Angeles County, California",Census Tract 5039.01,697,608,89,624700
06037503902,"Census Tract 5039.02, Los Angeles County, California",Census Tract 5039.02,1502,1261,241,615800
06037504001,"Census Tract 5040.01, Los Angeles County, California",Census Tract 5040.01,1407,1026,381,608800
06037504002,"Census Tract 5040.02, Los Angeles County, California",Census Tract 5040.02,1499,1227,272,625900
06037504101,"Census Tract 5041.01, Los Angeles County, California",Census Tract 5041.01,1305,790,515,505200
06037504200,"Census Tract 5042, Los Angeles County, California",Census Tract 5042,2273,808,1465,563900
06037530005,"Census Tract 5300.05, Los Angeles County, California",Census Tract 5300.05,1246,912,334,698200
06037530006,"Census Tract 5300.06, Los Angeles County, California",Census Tract 5300.06,1649,384,1265,509500
06037530007,"Census Tract 5300.07, Los Angeles County, California",Census Tract 5300.07,2075,1536,539,640700
06037530101,"Census Tract 5301.01, Los Angeles County, California",Census Tract 5301.01,1691,441,1250,467500
06037530102,"Census Tract 5301.02, Los Angeles County, California",Census Tract 5301.02,1576,528,1048,567500
06037530202,"Census Tract 5302.02, Los Angeles County, California",Census Tract 5302.02,1290,939,351,586400
06037530203,"Census Tract 5302.03, Los Angeles County, California",Census Tract 5302.03,894,218,676,583900
06037530204,"Census Tract 5302.04, Los Angeles County, California",Census Tract 5302.04,1199,421,778,478800
06037530301,"Census Tract 5303.01, Los Angeles County, California",Census Tract 5303.01,605,227,378,426000
06037530302,"Census Tract 5303.02, Los Angeles County, California",Census Tract 5303.02,1944,836,1108,478300
06037530400,"Census Tract 5304, Los Angeles County, California",Census Tract 5304,1177,383,794,554200
06037530500,"Census Tract 5305, Los Angeles County, California",Census Tract 5305,1097,475,622,461400
06037530603,"Census Tract 5306.03, Los Angeles County, California",Census Tract 5306.03,1242,677,565,492700
06037530700,"Census Tract 5307, Los Angeles County, California",Census Tract 5307,547,225,322,487200
06037530801,"Census Tract 5308.01, Los Angeles County, California",Census Tract 5308.01,1376,588,788,476600
06037530802,"Census Tract 5308.02, Los Angeles County, California",Census Tract 5308.02,832,482,350,487200
06037530901,"Census Tract 5309.01, Los Angeles County, California",Census Tract 5309.01,953,228,725,485700
06037530902,"Census Tract 5309.02, Los Angeles County, California",Census Tract 5309.02,1174,357,817,474300
06037531000,"Census Tract 5310, Los Angeles County, California",Census Tract 5310,1223,553,670,464100
06037531101,"Census Tract 5311.01, Los Angeles County, California",Census Tract 5311.01,1174,369,805,512700
06037531102,"Census Tract 5311.02, Los Angeles County, California",Census Tract 5311.02,841,212,629,532600
06037531201,"Census Tract 5312.01, Los Angeles County, California",Census Tract 5312.01,1136,238,898,483300
06037531202,"Census Tract 5312.02, Los Angeles County, California",Census Tract 5312.02,1130,331,799,501000
06037531301,"Census Tract 5313.01, Los Angeles County, California",Census Tract 5313.01,1392,237,1155,443900
06037531302,"Census Tract 5313.02, Los Angeles County, California",Census Tract 5313.02,1423,410,1013,497400
06037531502,"Census Tract 5315.02, Los Angeles County, California",Census Tract 5315.02,803,228,575,471700
06037531503,"Census Tract 5315.03, Los Angeles County, California",Census Tract 5315.03,798,208,590,492900
06037531504,"Census Tract 5315.04, Los Angeles County, California",Census Tract 5315.04,929,317,612,575400
06037531602,"Census Tract 5316.02, Los Angeles County, California",Census Tract 5316.02,1028,247,781,451700
06037531603,"Census Tract 5316.03, Los Angeles County, California",Census Tract 5316.03,945,341,604,448500
06037531604,"Census Tract 5316.04, Los Angeles County, California",Census Tract 5316.04,826,251,575,462300
06037531701,"Census Tract 5317.01, Los Angeles County, California",Census Tract 5317.01,1401,630,771,478100
06037531702,"Census Tract 5317.02, Los Angeles County, California",Census Tract 5317.02,1411,394,1017,491100
06037531800,"Census Tract 5318, Los Angeles County, California",Census Tract 5318,1350,344,1006,511100
06037531901,"Census Tract 5319.01, Los Angeles County, California",Census Tract 5319.01,1721,577,1144,451000
06037531902,"Census Tract 5319.02, Los Angeles County, California",Census Tract 5319.02,1150,546,604,438600
06037532001,"Census Tract 5320.01, Los Angeles County, California",Census Tract 5320.01,956,283,673,484600
06037532002,"Census Tract 5320.02, Los Angeles County, California",Census Tract 5320.02,1025,443,582,445000
06037532101,"Census Tract 5321.01, Los Angeles County, California",Census Tract 5321.01,1916,584,1332,485700
06037532102,"Census Tract 5321.02, Los Angeles County, California",Census Tract 5321.02,914,612,302,515300
06037532200,"Census Tract 5322, Los Angeles County, California",Census Tract 5322,1755,505,1250,503900
06037532302,"Census Tract 5323.02, Los Angeles County, California",Census Tract 5323.02,1186,826,360,418900
06037532303,"Census Tract 5323.03, Los Angeles County, California",Census Tract 5323.03,1277,695,582,475700
06037532304,"Census Tract 5323.04, Los Angeles County, California",Census Tract 5323.04,1033,475,558,507300
06037532500,"Census Tract 5325, Los Angeles County, California",Census Tract 5325,1106,489,617,399700
06037532605,"Census Tract 5326.05, Los Angeles County, California",Census Tract 5326.05,1165,184,981,393700
06037532606,"Census Tract 5326.06, Los Angeles County, California",Census Tract 5326.06,1212,72,1140,458300
06037532607,"Census Tract 5326.07, Los Angeles County, California",Census Tract 5326.07,1324,284,1040,469200
06037532700,"Census Tract 5327, Los Angeles County, California",Census Tract 5327,731,174,557,299100
06037532800,"Census Tract 5328, Los Angeles County, California",Census Tract 5328,929,354,575,420200
06037532900,"Census Tract 5329, Los Angeles County, California",Census Tract 5329,1588,412,1176,373300
06037533001,"Census Tract 5330.01, Los Angeles County, California",Census Tract 5330.01,1049,439,610,453600
06037533002,"Census Tract 5330.02, Los Angeles County, California",Census Tract 5330.02,574,218,356,408000
06037533103,"Census Tract 5331.03, Los Angeles County, California",Census Tract 5331.03,709,110,599,422400
06037533104,"Census Tract 5331.04, Los Angeles County, California",Census Tract 5331.04,1262,138,1124,480000
06037533105,"Census Tract 5331.05, Los Angeles County, California",Census Tract 5331.05,650,55,595,528200
06037533108,"Census Tract 5331.08, Los Angeles County, California",Census Tract 5331.08,1248,195,1053,473700
06037533201,"Census Tract 5332.01, Los Angeles County, California",Census Tract 5332.01,650,190,460,425500
06037533204,"Census Tract 5332.04, Los Angeles County, California",Census Tract 5332.04,1008,372,636,454700
06037533300,"Census Tract 5333, Los Angeles County, California",Census Tract 5333,833,182,651,552600
06037533401,"Census Tract 5334.01, Los Angeles County, California",Census Tract 5334.01,1211,349,862,403800
06037533402,"Census Tract 5334.02, Los Angeles County, California",Census Tract 5334.02,976,235,741,461500
06037533403,"Census Tract 5334.03, Los Angeles County, California",Census Tract 5334.03,750,334,416,593800
06037533501,"Census Tract 5335.01, Los Angeles County, California",Census Tract 5335.01,723,265,458,459900
06037533504,"Census Tract 5335.04, Los Angeles County, California",Census Tract 5335.04,924,238,686,456800
06037533601,"Census Tract 5336.01, Los Angeles County, California",Census Tract 5336.01,1122,194,928,585500
06037533602,"Census Tract 5336.02, Los Angeles County, California",Census Tract 5336.02,1337,354,983,462900
06037533603,"Census Tract 5336.03, Los Angeles County, California",Census Tract 5336.03,1745,459,1286,486700
06037533701,"Census Tract 5337.01, Los Angeles County, California",Census Tract 5337.01,809,154,655,360600
06037533702,"Census Tract 5337.02, Los Angeles County, California",Census Tract 5337.02,864,230,634,466000
06037533703,"Census Tract 5337.03, Los Angeles County, California",Census Tract 5337.03,889,244,645,575300
06037533803,"Census Tract 5338.03, Los Angeles County, California",Census Tract 5338.03,1537,482,1055,485200
06037533804,"Census Tract 5338.04, Los Angeles County, California",Census Tract 5338.04,1030,429,601,419800
06037533805,"Census Tract 5338.05, Los Angeles County, California",Census Tract 5338.05,1076,438,638,453300
06037533806,"Census Tract 5338.06, Los Angeles County, California",Census Tract 5338.06,898,300,598,
06037533901,"Census Tract 5339.01, Los Angeles County, California",Census Tract 5339.01,1295,242,1053,452300
06037533902,"Census Tract 5339.02, Los Angeles County, California",Census Tract 5339.02,966,249,717,463100
06037534001,"Census Tract 5340.01, Los Angeles County, California",Census Tract 5340.01,1310,244,1066,425600
06037534002,"Census Tract 5340.02, Los Angeles County, California",Census Tract 5340.02,926,275,651,417000
06037534101,"Census Tract 5341.01, Los Angeles County, California",Census Tract 5341.01,486,135,351,383100
06037534102,"Census Tract 5341.02, Los Angeles County, California",Census Tract 5341.02,1387,177,1210,472200
06037534201,"Census Tract 5342.01, Los Angeles County, California",Census Tract 5342.01,939,206,733,
06037534202,"Census Tract 5342.02, Los Angeles County, California",Census Tract 5342.02,1191,267,924,
06037534203,"Census Tract 5342.03, Los Angeles County, California",Census Tract 5342.03,830,176,654,372700
06037534301,"Census Tract 5343.01, Los Angeles County, California",Census Tract 5343.01,1079,147,932,441400
06037534302,"Census Tract 5343.02, Los Angeles County, California",Census Tract 5343.02,874,130,744,472600
06037534403,"Census Tract 5344.03, Los Angeles County, California",Census Tract 5344.03,801,63,738,464300
06037534404,"Census Tract 5344.04, Los Angeles County, California",Census Tract 5344.04,943,246,697,425600
06037534405,"Census Tract 5344.05, Los Angeles County, California",Census Tract 5344.05,950,199,751,
06037534406,"Census Tract 5344.06, Los Angeles County, California",Census Tract 5344.06,1128,47,1081,416100
06037534501,"Census Tract 5345.01, Los Angeles County, California",Census Tract 5345.01,1268,462,806,446300
06037534502,"Census Tract 5345.02, Los Angeles County, California",Census Tract 5345.02,930,672,258,459500
06037534700,"Census Tract 5347, Los Angeles County, California",Census Tract 5347,999,668,331,466900
06037534802,"Census Tract 5348.02, Los Angeles County, California",Census Tract 5348.02,632,325,307,467600
06037534803,"Census Tract 5348.03, Los Angeles County, California",Census Tract 5348.03,1195,591,604,422300
06037534804,"Census Tract 5348.04, Los Angeles County, California",Census Tract 5348.04,989,496,493,470500
06037534900,"Census Tract 5349, Los Angeles County, California",Census Tract 5349,1323,430,893,460300
06037535001,"Census Tract 5350.01, Los Angeles County, California",Census Tract 5350.01,935,417,518,457900
06037535002,"Census Tract 5350.02, Los Angeles County, California",Census Tract 5350.02,883,333,550,444000
06037535101,"Census Tract 5351.01, Los Angeles County, California",Census Tract 5351.01,1993,588,1405,393300
06037535102,"Census Tract 5351.02, Los Angeles County, California",Census Tract 5351.02,1068,408,660,448300
06037535200,"Census Tract 5352, Los Angeles County, California",Census Tract 5352,1234,715,519,418100
06037535300,"Census Tract 5353, Los Angeles County, California",Census Tract 5353,1395,726,669,421500
06037535400,"Census Tract 5354, Los Angeles County, California",Census Tract 5354,767,336,431,343000
06037535501,"Census Tract 5355.01, Los Angeles County, California",Census Tract 5355.01,898,198,700,602800
06037535502,"Census Tract 5355.02, Los Angeles County, California",Census Tract 5355.02,1306,491,815,574600
06037535503,"Census Tract 5355.03, Los Angeles County, California",Census Tract 5355.03,668,282,386,474500
06037535603,"Census Tract 5356.03, Los Angeles County, California",Census Tract 5356.03,994,279,715,456800
06037535604,"Census Tract 5356.04, Los Angeles County, California",Census Tract 5356.04,1027,399,628,472800
06037535605,"Census Tract 5356.05, Los Angeles County, California",Census Tract 5356.05,1119,344,775,524800
06037535606,"Census Tract 5356.06, Los Angeles County, California",Census Tract 5356.06,462,193,269,454500
06037535607,"Census Tract 5356.07, Los Angeles County, California",Census Tract 5356.07,1011,695,316,456400
06037535701,"Census Tract 5357.01, Los Angeles County, California",Census Tract 5357.01,1404,523,881,460600
06037535702,"Census Tract 5357.02, Los Angeles County, California",Census Tract 5357.02,1395,413,982,464600
06037535802,"Census Tract 5358.02, Los Angeles County, California",Census Tract 5358.02,1540,815,725,456500
06037535803,"Census Tract 5358.03, Los Angeles County, California",Census Tract 5358.03,973,322,651,481400
06037535804,"Census Tract 5358.04, Los Angeles County, California",Census Tract 5358.04,1450,519,931,490200
06037535901,"Census Tract 5359.01, Los Angeles County, California",Census Tract 5359.01,1652,793,859,481500
06037535902,"Census Tract 5359.02, Los Angeles County, California",Census Tract 5359.02,1419,971,448,476900
06037536000,"Census Tract 5360, Los Angeles County, California",Census Tract 5360,978,271,707,458300
06037536102,"Census Tract 5361.02, Los Angeles County, California",Census Tract 5361.02,1012,730,282,382100
06037536103,"Census Tract 5361.03, Los Angeles County, California",Census Tract 5361.03,1425,753,672,442700
06037536104,"Census Tract 5361.04, Los Angeles County, California",Census Tract 5361.04,1029,449,580,482500
06037536201,"Census Tract 5362.01, Los Angeles County, California",Census Tract 5362.01,891,656,235,489800
06037536202,"Census Tract 5362.02, Los Angeles County, California",Census Tract 5362.02,1205,621,584,483900
06037540000,"Census Tract 5400, Los Angeles County, California",Census Tract 5400,1576,638,938,457600
06037540101,"Census Tract 5401.01, Los Angeles County, California",Census Tract 5401.01,1515,1080,435,438000
06037540102,"Census Tract 5401.02, Los Angeles County, California",Census Tract 5401.02,1341,1007,334,450300
06037540201,"Census Tract 5402.01, Los Angeles County, California",Census Tract 5402.01,550,92,458,378000
06037540202,"Census Tract 5402.02, Los Angeles County, California",Census Tract 5402.02,1565,338,1227,464900
06037540203,"Census Tract 5402.03, Los Angeles County, California",Census Tract 5402.03,1307,403,904,421000
06037540300,"Census Tract 5403, Los Angeles County, California",Census Tract 5403,1203,770,433,391100
06037540400,"Census Tract 5404, Los Angeles County, California",Census Tract 5404,450,213,237,362700
06037540501,"Census Tract 5405.01, Los Angeles County, California",Census Tract 5405.01,906,553,353,457900
06037540502,"Census Tract 5405.02, Los Angeles County, California",Census Tract 5405.02,1613,221,1392,550200
06037540600,"Census Tract 5406, Los Angeles County, California",Census Tract 5406,1169,405,764,359700
06037540700,"Census Tract 5407, Los Angeles County, California",Census Tract 5407,835,429,406,439500
06037540800,"Census Tract 5408, Los Angeles County, California",Census Tract 5408,1456,1011,445,452200
06037540901,"Census Tract 5409.01, Los Angeles County, California",Census Tract 5409.01,1216,810,406,412800
06037540902,"Census Tract 5409.02, Los Angeles County, California",Census Tract 5409.02,1489,953,536,452200
06037541003,"Census Tract 5410.03, Los Angeles County, California",Census Tract 5410.03,1357,1150,207,459000
06037541100,"Census Tract 5411, Los Angeles County, California",Census Tract 5411,886,617,269,434000
06037541200,"Census Tract 5412, Los Angeles County, California",Census Tract 5412,1876,1467,409,459900
06037541300,"Census Tract 5413, Los Angeles County, California",Census Tract 5413,1479,1116,363,427100
06037541401,"Census Tract 5414.01, Los Angeles County, California",Census Tract 5414.01,942,259,683,338900
06037541402,"Census Tract 5414.02, Los Angeles County, California",Census Tract 5414.02,815,490,325,355000
06037541500,"Census Tract 5415, Los Angeles County, California",Census Tract 5415,1380,508,872,415700
06037541603,"Census Tract 5416.03, Los Angeles County, California",Census Tract 5416.03,743,356,387,365000
06037541604,"Census Tract 5416.04, Los Angeles County, California",Census Tract 5416.04,1348,401,947,421900
06037541605,"Census Tract 5416.05, Los Angeles County, California",Census Tract 5416.05,1491,708,783,377900
06037541606,"Census Tract 5416.06, Los Angeles County, California",Census Tract 5416.06,675,155,520,465000
06037541700,"Census Tract 5417, Los Angeles County, California",Census Tract 5417,1347,957,390,463300
06037541801,"Census Tract 5418.01, Los Angeles County, California",Census Tract 5418.01,1139,486,653,444900
06037541802,"Census Tract 5418.02, Los Angeles County, California",Census Tract 5418.02,1231,915,316,456400
06037542000,"Census Tract 5420, Los Angeles County, California",Census Tract 5420,1155,846,309,435600
06037542103,"Census Tract 5421.03, Los Angeles County, California",Census Tract 5421.03,776,414,362,371200
06037542104,"Census Tract 5421.04, Los Angeles County, California",Census Tract 5421.04,871,474,397,406800
06037542105,"Census Tract 5421.05, Los Angeles County, California",Census Tract 5421.05,1172,428,744,400000
06037542106,"Census Tract 5421.06, Los Angeles County, California",Census Tract 5421.06,756,301,455,417500
06037542200,"Census Tract 5422, Los Angeles County, California",Census Tract 5422,1464,1074,390,386700
06037542401,"Census Tract 5424.01, Los Angeles County, California",Census Tract 5424.01,1200,792,408,444600
06037542402,"Census Tract 5424.02, Los Angeles County, California",Census Tract 5424.02,942,620,322,428100
06037542501,"Census Tract 5425.01, Los Angeles County, California",Census Tract 5425.01,1250,563,687,478900
06037542502,"Census Tract 5425.02, Los Angeles County, California",Census Tract 5425.02,1376,463,913,445400
06037542601,"Census Tract 5426.01, Los Angeles County, California",Census Tract 5426.01,814,251,563,436300
06037542602,"Census Tract 5426.02, Los Angeles County, California",Census Tract 5426.02,1394,618,776,418100
06037542700,"Census Tract 5427, Los Angeles County, California",Census Tract 5427,1440,973,467,416000
06037542800,"Census Tract 5428, Los Angeles County, California",Census Tract 5428,967,813,154,381900
06037542900,"Census Tract 5429, Los Angeles County, California",Census Tract 5429,810,572,238,397200
06037543000,"Census Tract 5430, Los Angeles County, California",Census Tract 5430,1224,866,358,423100
06037543100,"Census Tract 5431, Los Angeles County, California",Census Tract 5431,1884,1555,329,448200
06037543201,"Census Tract 5432.01, Los Angeles County, California",Census Tract 5432.01,903,526,377,444900
06037543203,"Census Tract 5432.03, Los Angeles County, California",Census Tract 5432.03,1123,487,636,373800
06037543304,"Census Tract 5433.04, Los Angeles County, California",Census Tract 5433.04,2137,1915,222,603600
06037543305,"Census Tract 5433.05, Los Angeles County, California",Census Tract 5433.05,1243,1172,71,136800
06037543306,"Census Tract 5433.06, Los Angeles County, California",Census Tract 5433.06,1815,1322,493,460300
06037543321,"Census Tract 5433.21, Los Angeles County, California",Census Tract 5433.21,2036,1600,436,570300
06037543322,"Census Tract 5433.22, Los Angeles County, California",Census Tract 5433.22,2094,1926,168,617100
06037543400,"Census Tract 5434, Los Angeles County, California",Census Tract 5434,952,790,162,540500
06037543501,"Census Tract 5435.01, Los Angeles County, California",Census Tract 5435.01,1875,995,880,465700
06037543502,"Census Tract 5435.02, Los Angeles County, California",Census Tract 5435.02,1699,1142,557,550100
06037543503,"Census Tract 5435.03, Los Angeles County, California",Census Tract 5435.03,1884,1181,703,579800
06037543601,"Census Tract 5436.01, Los Angeles County, California",Census Tract 5436.01,1154,746,408,538000
06037543603,"Census Tract 5436.03, Los Angeles County, California",Census Tract 5436.03,1431,1373,58,520400
06037543605,"Census Tract 5436.05, Los Angeles County, California",Census Tract 5436.05,1530,1282,248,444200
06037543606,"Census Tract 5436.06, Los Angeles County, California",Census Tract 5436.06,1229,677,552,494800
06037543607,"Census Tract 5436.07, Los Angeles County, California",Census Tract 5436.07,1344,1230,114,596000
06037543701,"Census Tract 5437.01, Los Angeles County, California",Census Tract 5437.01,676,556,120,551300
06037543703,"Census Tract 5437.03, Los Angeles County, California",Census Tract 5437.03,1047,706,341,578200
06037543704,"Census Tract 5437.04, Los Angeles County, California",Census Tract 5437.04,819,627,192,535500
06037543705,"Census Tract 5437.05, Los Angeles County, California",Census Tract 5437.05,990,654,336,511700
06037543801,"Census Tract 5438.01, Los Angeles County, California",Census Tract 5438.01,1300,1013,287,435400
06037543803,"Census Tract 5438.03, Los Angeles County, California",Census Tract 5438.03,1349,866,483,492000
06037543804,"Census Tract 5438.04, Los Angeles County, California",Census Tract 5438.04,796,578,218,574700
06037543903,"Census Tract 5439.03, Los Angeles County, California",Census Tract 5439.03,1116,780,336,498900
06037543905,"Census Tract 5439.05, Los Angeles County, California",Census Tract 5439.05,1056,483,573,411300
06037544001,"Census Tract 5440.01, Los Angeles County, California",Census Tract 5440.01,1269,906,363,465400
06037544002,"Census Tract 5440.02, Los Angeles County, California",Census Tract 5440.02,842,578,264,543800
06037550101,"Census Tract 5501.01, Los Angeles County, California",Census Tract 5501.01,1051,905,146,494900
06037550201,"Census Tract 5502.01, Los Angeles County, California",Census Tract 5502.01,774,436,338,569300
06037550202,"Census Tract 5502.02, Los Angeles County, California",Census Tract 5502.02,1484,1131,353,465300
06037550301,"Census Tract 5503.01, Los Angeles County, California",Census Tract 5503.01,1086,729,357,468100
06037550501,"Census Tract 5505.01, Los Angeles County, California",Census Tract 5505.01,1094,444,650,593100
06037550502,"Census Tract 5505.02, Los Angeles County, California",Census Tract 5505.02,1215,925,290,817000
06037550601,"Census Tract 5506.01, Los Angeles County, California",Census Tract 5506.01,1870,970,900,616100
06037550602,"Census Tract 5506.02, Los Angeles County, California",Census Tract 5506.02,1159,1000,159,663700
06037550700,"Census Tract 5507, Los Angeles County, California",Census Tract 5507,1999,1533,466,622600
06037550801,"Census Tract 5508.01, Los Angeles County, California",Census Tract 5508.01,1556,954,602,648800
06037550802,"Census Tract 5508.02, Los Angeles County, California",Census Tract 5508.02,599,221,378,654200
06037550901,"Census Tract 5509.01, Los Angeles County, California",Census Tract 5509.01,1355,262,1093,689100
06037550902,"Census Tract 5509.02, Los Angeles County, California",Census Tract 5509.02,1853,566,1287,692700
06037551001,"Census Tract 5510.01, Los Angeles County, California",Census Tract 5510.01,905,632,273,643100
06037551002,"Census Tract 5510.02, Los Angeles County, California",Census Tract 5510.02,1412,870,542,650200
06037551101,"Census Tract 5511.01, Los Angeles County, California",Census Tract 5511.01,1248,562,686,399100
06037551102,"Census Tract 5511.02, Los Angeles County, California",Census Tract 5511.02,1829,217,1612,605200
06037551201,"Census Tract 5512.01, Los Angeles County, California",Census Tract 5512.01,1194,411,783,627800
06037551203,"Census Tract 5512.03, Los Angeles County, California",Census Tract 5512.03,1154,724,430,590800
06037551204,"Census Tract 5512.04, Los Angeles County, California",Census Tract 5512.04,1133,350,783,610000
06037551300,"Census Tract 5513, Los Angeles County, California",Census Tract 5513,1843,428,1415,382100
06037551401,"Census Tract 5514.01, Los Angeles County, California",Census Tract 5514.01,1308,503,805,585000
06037551402,"Census Tract 5514.02, Los Angeles County, California",Census Tract 5514.02,1434,787,647,623800
06037551501,"Census Tract 5515.01, Los Angeles County, California",Census Tract 5515.01,1447,752,695,533900
06037551502,"Census Tract 5515.02, Los Angeles County, California",Census Tract 5515.02,1413,738,675,638900
06037551700,"Census Tract 5517, Los Angeles County, California",Census Tract 5517,1712,1026,686,584200
06037551801,"Census Tract 5518.01, Los Angeles County, California",Census Tract 5518.01,943,550,393,497300
06037551802,"Census Tract 5518.02, Los Angeles County, California",Census Tract 5518.02,1427,571,856,495600
06037551900,"Census Tract 5519, Los Angeles County, California",Census Tract 5519,1343,1057,286,503100
06037552001,"Census Tract 5520.01, Los Angeles County, California",Census Tract 5520.01,1016,716,300,485700
06037552002,"Census Tract 5520.02, Los Angeles County, California",Census Tract 5520.02,929,418,511,451000
06037552100,"Census Tract 5521, Los Angeles County, California",Census Tract 5521,1806,1188,618,478000
06037552200,"Census Tract 5522, Los Angeles County, California",Census Tract 5522,1554,348,1206,465200
06037552301,"Census Tract 5523.01, Los Angeles County, California",Census Tract 5523.01,1114,756,358,451900
06037552302,"Census Tract 5523.02, Los Angeles County, California",Census Tract 5523.02,1327,720,607,561300
06037552400,"Census Tract 5524, Los Angeles County, California",Census Tract 5524,563,433,130,471500
06037552601,"Census Tract 5526.01, Los Angeles County, California",Census Tract 5526.01,1183,825,358,457500
06037552602,"Census Tract 5526.02, Los Angeles County, California",Census Tract 5526.02,964,615,349,540700
06037552700,"Census Tract 5527, Los Angeles County, California",Census Tract 5527,1582,1276,306,524000
06037552800,"Census Tract 5528, Los Angeles County, California",Census Tract 5528,1632,1171,461,539500
06037552900,"Census Tract 5529, Los Angeles County, California",Census Tract 5529,1886,1065,821,490000
06037553000,"Census Tract 5530, Los Angeles County, California",Census Tract 5530,1141,961,180,503400
06037553100,"Census Tract 5531, Los Angeles County, California",Census Tract 5531,1932,988,944,606900
06037553201,"Census Tract 5532.01, Los Angeles County, California",Census Tract 5532.01,983,682,301,563300
06037553202,"Census Tract 5532.02, Los Angeles County, California",Census Tract 5532.02,952,766,186,548600
06037553300,"Census Tract 5533, Los Angeles County, California",Census Tract 5533,979,776,203,499400
06037553400,"Census Tract 5534, Los Angeles County, California",Census Tract 5534,1026,585,441,467500
06037553502,"Census Tract 5535.02, Los Angeles County, California",Census Tract 5535.02,1149,398,751,334500
06037553503,"Census Tract 5535.03, Los Angeles County, California",Census Tract 5535.03,830,307,523,423600
06037553504,"Census Tract 5535.04, Los Angeles County, California",Census Tract 5535.04,1312,709,603,428700
06037553601,"Census Tract 5536.01, Los Angeles County, California",Census Tract 5536.01,1307,421,886,471300
06037553602,"Census Tract 5536.02, Los Angeles County, California",Census Tract 5536.02,1371,481,890,429200
06037553701,"Census Tract 5537.01, Los Angeles County, California",Census Tract 5537.01,922,375,547,334000
06037553702,"Census Tract 5537.02, Los Angeles County, California",Census Tract 5537.02,1253,679,574,421900
06037553801,"Census Tract 5538.01, Los Angeles County, California",Census Tract 5538.01,1039,318,721,441000
06037553802,"Census Tract 5538.02, Los Angeles County, California",Census Tract 5538.02,2073,987,1086,
06037553901,"Census Tract 5539.01, Los Angeles County, California",Census Tract 5539.01,1548,802,746,485000
06037553902,"Census Tract 5539.02, Los Angeles County, California",Census Tract 5539.02,1543,503,1040,264000
06037554001,"Census Tract 5540.01, Los Angeles County, California",Census Tract 5540.01,1204,785,419,585600
06037554002,"Census Tract 5540.02, Los Angeles County, California",Census Tract 5540.02,1714,635,1079,542900
06037554101,"Census Tract 5541.01, Los Angeles County, California",Census Tract 5541.01,967,292,675,461700
06037554105,"Census Tract 5541.05, Los Angeles County, California",Census Tract 5541.05,1495,76,1419,
06037554106,"Census Tract 5541.06, Los Angeles County, California",Census Tract 5541.06,1291,519,772,591000
06037554201,"Census Tract 5542.01, Los Angeles County, California",Census Tract 5542.01,1089,637,452,496200
06037554203,"Census Tract 5542.03, Los Angeles County, California",Census Tract 5542.03,1303,409,894,555300
06037554204,"Census Tract 5542.04, Los Angeles County, California",Census Tract 5542.04,1810,209,1601,459000
06037554301,"Census Tract 5543.01, Los Angeles County, California",Census Tract 5543.01,1053,385,668,494100
06037554302,"Census Tract 5543.02, Los Angeles County, California",Census Tract 5543.02,1186,257,929,
06037554403,"Census Tract 5544.03, Los Angeles County, California",Census Tract 5544.03,1794,405,1389,398800
06037554404,"Census Tract 5544.04, Los Angeles County, California",Census Tract 5544.04,1326,273,1053,438100
06037554405,"Census Tract 5544.05, Los Angeles County, California",Census Tract 5544.05,1365,204,1161,505600
06037554406,"Census Tract 5544.06, Los Angeles County, California",Census Tract 5544.06,1575,828,747,621200
06037554511,"Census Tract 5545.11, Los Angeles County, California",Census Tract 5545.11,1118,802,316,775900
06037554512,"Census Tract 5545.12, Los Angeles County, California",Census Tract 5545.12,2164,1499,665,817600
06037554513,"Census Tract 5545.13, Los Angeles County, California",Census Tract 5545.13,815,649,166,681000
06037554514,"Census Tract 5545.14, Los Angeles County, California",Census Tract 5545.14,1587,1031,556,632600
06037554515,"Census Tract 5545.15, Los Angeles County, California",Census Tract 5545.15,1127,943,184,672600
06037554516,"Census Tract 5545.16, Los Angeles County, California",Census Tract 5545.16,1208,1076,132,838600
06037554517,"Census Tract 5545.17, Los Angeles County, California",Census Tract 5545.17,1386,894,492,793200
06037554518,"Census Tract 5545.18, Los Angeles County, California",Census Tract 5545.18,1573,1354,219,782500
06037554519,"Census Tract 5545.19, Los Angeles County, California",Census Tract 5545.19,1217,1085,132,844200
06037554521,"Census Tract 5545.21, Los Angeles County, California",Census Tract 5545.21,1902,1303,599,753800
06037554522,"Census Tract 5545.22, Los Angeles County, California",Census Tract 5545.22,1485,1248,237,707900
06037554600,"Census Tract 5546, Los Angeles County, California",Census Tract 5546,1206,657,549,497000
06037554700,"Census Tract 5547, Los Angeles County, California",Census Tract 5547,936,669,267,476100
06037554801,"Census Tract 5548.01, Los Angeles County, California",Census Tract 5548.01,730,499,231,539900
06037554802,"Census Tract 5548.02, Los Angeles County, California",Census Tract 5548.02,1691,967,724,726200
06037554900,"Census Tract 5549, Los Angeles County, California",Census Tract 5549,1996,889,1107,616800
06037555001,"Census Tract 5550.01, Los Angeles County, California",Census Tract 5550.01,1626,1021,605,586800
06037555002,"Census Tract 5550.02, Los Angeles County, California",Census Tract 5550.02,1258,522,736,596500
06037555105,"Census Tract 5551.05, Los Angeles County, California",Census Tract 5551.05,1807,814,993,474700
06037555106,"Census Tract 5551.06, Los Angeles County, California",Census Tract 5551.06,938,405,533,471100
06037555107,"Census Tract 5551.07, Los Angeles County, California",Census Tract 5551.07,1924,1351,573,552300
06037555202,"Census Tract 5552.02, Los Angeles County, California",Census Tract 5552.02,1082,970,112,761300
06037555211,"Census Tract 5552.11, Los Angeles County, California",Census Tract 5552.11,1360,595,765,449800
06037555212,"Census Tract 5552.12, Los Angeles County, California",Census Tract 5552.12,1435,714,721,380900
06037555300,"Census Tract 5553, Los Angeles County, California",Census Tract 5553,986,863,123,465700
06037570001,"Census Tract 5700.01, Los Angeles County, California",Census Tract 5700.01,1608,1208,400,651800
06037570002,"Census Tract 5700.02, Los Angeles County, California",Census Tract 5700.02,805,638,167,627100
06037570003,"Census Tract 5700.03, Los Angeles County, California",Census Tract 5700.03,1337,1133,204,607000
06037570100,"Census Tract 5701, Los Angeles County, California",Census Tract 5701,735,570,165,580500
06037570202,"Census Tract 5702.02, Los Angeles County, California",Census Tract 5702.02,1759,1169,590,455000
06037570203,"Census Tract 5702.03, Los Angeles County, California",Census Tract 5702.03,1288,220,1068,490500
06037570204,"Census Tract 5702.04, Los Angeles County, California",Census Tract 5702.04,1314,422,892,567400
06037570303,"Census Tract 5703.03, Los Angeles County, California",Census Tract 5703.03,1287,474,813,438500
06037570304,"Census Tract 5703.04, Los Angeles County, California",Census Tract 5703.04,1520,518,1002,423800
06037570305,"Census Tract 5703.05, Los Angeles County, California",Census Tract 5703.05,1372,330,1042,95200
06037570306,"Census Tract 5703.06, Los Angeles County, California",Census Tract 5703.06,916,508,408,458200
06037570402,"Census Tract 5704.02, Los Angeles County, California",Census Tract 5704.02,1020,777,243,470200
06037570403,"Census Tract 5704.03, Los Angeles County, California",Census Tract 5704.03,1072,391,681,446000
06037570404,"Census Tract 5704.04, Los Angeles County, California",Census Tract 5704.04,927,647,280,465100
06037570502,"Census Tract 5705.02, Los Angeles County, California",Census Tract 5705.02,1970,982,988,508000
06037570503,"Census Tract 5705.03, Los Angeles County, California",Census Tract 5705.03,1222,796,426,545500
06037570504,"Census Tract 5705.04, Los Angeles County, California",Census Tract 5705.04,1019,684,335,487500
06037570601,"Census Tract 5706.01, Los Angeles County, California",Census Tract 5706.01,1633,782,851,453800
06037570602,"Census Tract 5706.02, Los Angeles County, California",Census Tract 5706.02,1677,733,944,496500
06037570603,"Census Tract 5706.03, Los Angeles County, California",Census Tract 5706.03,1732,312,1420,
06037570701,"Census Tract 5707.01, Los Angeles County, California",Census Tract 5707.01,2622,1386,1236,626900
06037570703,"Census Tract 5707.03, Los Angeles County, California",Census Tract 5707.03,972,826,146,600800
06037570800,"Census Tract 5708, Los Angeles County, California",Census Tract 5708,1752,1403,349,616200
06037570901,"Census Tract 5709.01, Los Angeles County, California",Census Tract 5709.01,1825,1558,267,640500
06037570902,"Census Tract 5709.02, Los Angeles County, California",Census Tract 5709.02,1207,878,329,629900
06037571000,"Census Tract 5710, Los Angeles County, California",Census Tract 5710,1853,1717,136,635500
06037571101,"Census Tract 5711.01, Los Angeles County, California",Census Tract 5711.01,1686,1519,167,624300
06037571102,"Census Tract 5711.02, Los Angeles County, California",Census Tract 5711.02,1215,1075,140,649500
06037571201,"Census Tract 5712.01, Los Angeles County, California",Census Tract 5712.01,1468,904,564,824000
06037571202,"Census Tract 5712.02, Los Angeles County, California",Census Tract 5712.02,1597,982,615,663100
06037571300,"Census Tract 5713, Los Angeles County, California",Census Tract 5713,1477,1381,96,678000
06037571400,"Census Tract 5714, Los Angeles County, California",Census Tract 5714,1732,1151,581,613800
06037571502,"Census Tract 5715.02, Los Angeles County, California",Census Tract 5715.02,1825,848,977,590200
06037571504,"Census Tract 5715.04, Los Angeles County, California",Census Tract 5715.04,1991,1009,982,623700
06037571505,"Census Tract 5715.05, Los Angeles County, California",Census Tract 5715.05,918,451,467,572000
06037571600,"Census Tract 5716, Los Angeles County, California",Census Tract 5716,839,31,808,312500
06037571701,"Census Tract 5717.01, Los Angeles County, California",Census Tract 5717.01,1758,621,1137,476900
06037571703,"Census Tract 5717.03, Los Angeles County, California",Census Tract 5717.03,1041,304,737,404000
06037571704,"Census Tract 5717.04, Los Angeles County, California",Census Tract 5717.04,1241,480,761,452100
06037571800,"Census Tract 5718, Los Angeles County, California",Census Tract 5718,1272,836,436,962000
06037571900,"Census Tract 5719, Los Angeles County, California",Census Tract 5719,2244,1078,1166,785400
06037572001,"Census Tract 5720.01, Los Angeles County, California",Census Tract 5720.01,2270,1558,712,696300
06037572201,"Census Tract 5722.01, Los Angeles County, California",Census Tract 5722.01,2012,1153,859,594800
06037572202,"Census Tract 5722.02, Los Angeles County, California",Census Tract 5722.02,1082,686,396,622200
06037572301,"Census Tract 5723.01, Los Angeles County, California",Census Tract 5723.01,917,495,422,455100
06037572500,"Census Tract 5725, Los Angeles County, California",Census Tract 5725,1411,433,978,297500
06037572600,"Census Tract 5726, Los Angeles County, California",Census Tract 5726,1197,938,259,431900
06037572700,"Census Tract 5727, Los Angeles County, California",Census Tract 5727,1364,970,394,483800
06037573002,"Census Tract 5730.02, Los Angeles County, California",Census Tract 5730.02,1073,68,1005,394400
06037573003,"Census Tract 5730.03, Los Angeles County, California",Census Tract 5730.03,611,369,242,597000
06037573004,"Census Tract 5730.04, Los Angeles County, California",Census Tract 5730.04,1636,191,1445,592200
06037573101,"Census Tract 5731.01, Los Angeles County, California",Census Tract 5731.01,1402,353,1049,589100
06037573102,"Census Tract 5731.02, Los Angeles County, California",Census Tract 5731.02,1011,521,490,616400
06037573201,"Census Tract 5732.01, Los Angeles County, California",Census Tract 5732.01,1229,352,877,451500
06037573202,"Census Tract 5732.02, Los Angeles County, California",Census Tract 5732.02,1687,681,1006,491800
06037573300,"Census Tract 5733, Los Angeles County, California",Census Tract 5733,1072,338,734,471300
06037573401,"Census Tract 5734.01, Los Angeles County, California",Census Tract 5734.01,546,167,379,674400
06037573402,"Census Tract 5734.02, Los Angeles County, California",Census Tract 5734.02,2617,997,1620,521900
06037573403,"Census Tract 5734.03, Los Angeles County, California",Census Tract 5734.03,1417,1068,349,544900
06037573601,"Census Tract 5736.01, Los Angeles County, California",Census Tract 5736.01,2361,2093,268,664000
06037573700,"Census Tract 5737, Los Angeles County, California",Census Tract 5737,1722,1558,164,673100
06037573800,"Census Tract 5738, Los Angeles County, California",Census Tract 5738,1507,1380,127,694600
06037573902,"Census Tract 5739.02, Los Angeles County, California",Census Tract 5739.02,883,778,105,813300
06037574000,"Census Tract 5740, Los Angeles County, California",Census Tract 5740,1938,1757,181,780100
06037574100,"Census Tract 5741, Los Angeles County, California",Census Tract 5741,1850,1455,395,673200
06037574201,"Census Tract 5742.01, Los Angeles County, California",Census Tract 5742.01,1054,898,156,663500
06037574202,"Census Tract 5742.02, Los Angeles County, California",Census Tract 5742.02,765,377,388,638400
06037574300,"Census Tract 5743, Los Angeles County, California",Census Tract 5743,2192,1603,589,720800
06037574400,"Census Tract 5744, Los Angeles County, California",Census Tract 5744,2016,1717,299,692600
06037574500,"Census Tract 5745, Los Angeles County, California",Census Tract 5745,2266,1905,361,744400
06037574602,"Census Tract 5746.02, Los Angeles County, California",Census Tract 5746.02,562,492,70,916700
06037574800,"Census Tract 5748, Los Angeles County, California",Census Tract 5748,1541,889,652,969400
06037574901,"Census Tract 5749.01, Los Angeles County, California",Census Tract 5749.01,1392,996,396,711200
06037574902,"Census Tract 5749.02, Los Angeles County, California",Census Tract 5749.02,1827,304,1523,590900
06037575001,"Census Tract 5750.01, Los Angeles County, California",Census Tract 5750.01,1825,694,1131,626700
06037575002,"Census Tract 5750.02, Los Angeles County, California",Census Tract 5750.02,1928,707,1221,622600
06037575101,"Census Tract 5751.01, Los Angeles County, California",Census Tract 5751.01,1511,361,1150,446300
06037575102,"Census Tract 5751.02, Los Angeles County, California",Census Tract 5751.02,1338,173,1165,485600
06037575103,"Census Tract 5751.03, Los Angeles County, California",Census Tract 5751.03,2124,379,1745,412500
06037575201,"Census Tract 5752.01, Los Angeles County, California",Census Tract 5752.01,1246,233,1013,431500
06037575202,"Census Tract 5752.02, Los Angeles County, California",Census Tract 5752.02,1134,181,953,450600
06037575300,"Census Tract 5753, Los Angeles County, California",Census Tract 5753,1327,102,1225,509400
06037575401,"Census Tract 5754.01, Los Angeles County, California",Census Tract 5754.01,1271,29,1242,
06037575402,"Census Tract 5754.02, Los Angeles County, California",Census Tract 5754.02,1122,197,925,276300
06037575801,"Census Tract 5758.01, Los Angeles County, California",Census Tract 5758.01,756,23,733,406300
06037575802,"Census Tract 5758.02, Los Angeles County, California",Census Tract 5758.02,1664,330,1334,450000
06037575803,"Census Tract 5758.03, Los Angeles County, California",Census Tract 5758.03,1312,183,1129,333000
06037575901,"Census Tract 5759.01, Los Angeles County, California",Census Tract 5759.01,1520,549,971,341200
06037575902,"Census Tract 5759.02, Los Angeles County, California",Census Tract 5759.02,3035,509,2526,400300
06037576001,"Census Tract 5760.01, Los Angeles County, California",Census Tract 5760.01,3506,1056,2450,450800
06037576200,"Census Tract 5762, Los Angeles County, California",Census Tract 5762,3174,592,2582,541900
06037576301,"Census Tract 5763.01, Los Angeles County, California",Census Tract 5763.01,1949,159,1790,474400
06037576302,"Census Tract 5763.02, Los Angeles County, California",Census Tract 5763.02,1093,143,950,462500
06037576401,"Census Tract 5764.01, Los Angeles County, California",Census Tract 5764.01,1296,143,1153,432600
06037576402,"Census Tract 5764.02, Los Angeles County, California",Census Tract 5764.02,1352,282,1070,483800
06037576403,"Census Tract 5764.03, Los Angeles County, California",Census Tract 5764.03,1426,208,1218,416200
06037576501,"Census Tract 5765.01, Los Angeles County, California",Census Tract 5765.01,1432,144,1288,456300
06037576502,"Census Tract 5765.02, Los Angeles County, California",Census Tract 5765.02,2080,356,1724,405700
06037576503,"Census Tract 5765.03, Los Angeles County, California",Census Tract 5765.03,1774,240,1534,540300
06037576601,"Census Tract 5766.01, Los Angeles County, California",Census Tract 5766.01,2595,572,2023,656700
06037576602,"Census Tract 5766.02, Los Angeles County, California",Census Tract 5766.02,2779,424,2355,762200
06037576700,"Census Tract 5767, Los Angeles County, California",Census Tract 5767,2103,932,1171,667900
06037576801,"Census Tract 5768.01, Los Angeles County, California",Census Tract 5768.01,1840,407,1433,489600
06037576802,"Census Tract 5768.02, Los Angeles County, California",Census Tract 5768.02,1793,405,1388,708000
06037576901,"Census Tract 5769.01, Los Angeles County, California",Census Tract 5769.01,1809,236,1573,553200
06037576903,"Census Tract 5769.03, Los Angeles County, California",Census Tract 5769.03,1326,172,1154,427400
06037576904,"Census Tract 5769.04, Los Angeles County, California",Census Tract 5769.04,1248,310,938,671600
06037577000,"Census Tract 5770, Los Angeles County, California",Census Tract 5770,3278,622,2656,597200
06037577100,"Census Tract 5771, Los Angeles County, California",Census Tract 5771,3389,1034,2355,709200
06037577200,"Census Tract 5772, Los Angeles County, California",Census Tract 5772,3238,741,2497,779300
06037577300,"Census Tract 5773, Los Angeles County, California",Census Tract 5773,3730,995,2735,1005400
06037577400,"Census Tract 5774, Los Angeles County, California",Census Tract 5774,1588,507,1081,1067900
06037577501,"Census Tract 5775.01, Los Angeles County, California",Census Tract 5775.01,1738,1160,578,1215300
06037577504,"Census Tract 5775.04, Los Angeles County, California",Census Tract 5775.04,718,326,392,1760200
06037577602,"Census Tract 5776.02, Los Angeles County, California",Census Tract 5776.02,1577,1076,501,695500
06037577604,"Census Tract 5776.04, Los Angeles County, California",Census Tract 5776.04,808,696,112,650400
06037577605,"Census Tract 5776.05, Los Angeles County, California",Census Tract 5776.05,2075,1670,405,1117000
06037577606,"Census Tract 5776.06, Los Angeles County, California",Census Tract 5776.06,1579,699,880,924800
06037577700,"Census Tract 5777, Los Angeles County, California",Census Tract 5777,1218,739,479,503000
06037577800,"Census Tract 5778, Los Angeles County, California",Census Tract 5778,1309,1032,277,535500
06037577900,"Census Tract 5779, Los Angeles County, California",Census Tract 5779,2505,1049,1456,459900
06037578000,"Census Tract 5780, Los Angeles County, California",Census Tract 5780,1649,418,1231,446600
06037578100,"Census Tract 5781, Los Angeles County, California",Census Tract 5781,0,0,0,
06037599000,"Census Tract 5990, Los Angeles County, California",Census Tract 5990,1489,490,999,884600
06037599100,"Census Tract 5991, Los Angeles County, California",Census Tract 5991,54,13,41,
06037600100,"Census Tract 6001, Los Angeles County, California",Census Tract 6001,2217,435,1782,533100
06037600201,"Census Tract 6002.01, Los Angeles County, California",Census Tract 6002.01,1340,241,1099,631300
06037600202,"Census Tract 6002.02, Los Angeles County, California",Census Tract 6002.02,2196,569,1627,438700
06037600302,"Census Tract 6003.02, Los Angeles County, California",Census Tract 6003.02,960,690,270,508200
06037600303,"Census Tract 6003.03, Los Angeles County, California",Census Tract 6003.03,1279,152,1127,423700
06037600304,"Census Tract 6003.04, Los Angeles County, California",Census Tract 6003.04,1069,167,902,419800
06037600400,"Census Tract 6004, Los Angeles County, California",Census Tract 6004,1475,756,719,593000
06037600501,"Census Tract 6005.01, Los Angeles County, California",Census Tract 6005.01,842,592,250,633300
06037600601,"Census Tract 6006.01, Los Angeles County, California",Census Tract 6006.01,877,498,379,638400
06037600602,"Census Tract 6006.02, Los Angeles County, California",Census Tract 6006.02,669,43,626,532900
06037600702,"Census Tract 6007.02, Los Angeles County, California",Census Tract 6007.02,1537,1039,498,675600
06037600703,"Census Tract 6007.03, Los Angeles County, California",Census Tract 6007.03,778,663,115,548300
06037600704,"Census Tract 6007.04, Los Angeles County, California",Census Tract 6007.04,1176,500,676,688100
06037600801,"Census Tract 6008.01, Los Angeles County, California",Census Tract 6008.01,1186,891,295,650800
06037600802,"Census Tract 6008.02, Los Angeles County, California",Census Tract 6008.02,1203,498,705,647600
06037600902,"Census Tract 6009.02, Los Angeles County, California",Census Tract 6009.02,2277,467,1810,614900
06037600911,"Census Tract 6009.11, Los Angeles County, California",Census Tract 6009.11,1064,518,546,622100
06037600912,"Census Tract 6009.12, Los Angeles County, California",Census Tract 6009.12,1424,808,616,572400
06037601001,"Census Tract 6010.01, Los Angeles County, California",Census Tract 6010.01,1063,189,874,753900
06037601002,"Census Tract 6010.02, Los Angeles County, California",Census Tract 6010.02,1974,469,1505,461300
06037601100,"Census Tract 6011, Los Angeles County, California",Census Tract 6011,1975,232,1743,508800
06037601202,"Census Tract 6012.02, Los Angeles County, California",Census Tract 6012.02,1054,520,534,579000
06037601211,"Census Tract 6012.11, Los Angeles County, California",Census Tract 6012.11,1064,196,868,576700
06037601212,"Census Tract 6012.12, Los Angeles County, California",Census Tract 6012.12,1989,451,1538,464800
06037601301,"Census Tract 6013.01, Los Angeles County, California",Census Tract 6013.01,712,459,253,761100
06037601302,"Census Tract 6013.02, Los Angeles County, California",Census Tract 6013.02,2729,630,2099,464100
06037601303,"Census Tract 6013.03, Los Angeles County, California",Census Tract 6013.03,2164,328,1836,472800
06037601401,"Census Tract 6014.01, Los Angeles County, California",Census Tract 6014.01,1717,429,1288,495500
06037601402,"Census Tract 6014.02, Los Angeles County, California",Census Tract 6014.02,1366,734,632,586100
06037601501,"Census Tract 6015.01, Los Angeles County, California",Census Tract 6015.01,1018,153,865,489100
06037601502,"Census Tract 6015.02, Los Angeles County, California",Census Tract 6015.02,926,318,608,583700
06037601600,"Census Tract 6016, Los Angeles County, California",Census Tract 6016,1230,449,781,563000
06037601700,"Census Tract 6017, Los Angeles County, California",Census Tract 6017,1304,225,1079,474800
06037601801,"Census Tract 6018.01, Los Angeles County, California",Census Tract 6018.01,862,272,590,623100
06037601802,"Census Tract 6018.02, Los Angeles County, California",Census Tract 6018.02,974,313,661,578700
06037601900,"Census Tract 6019, Los Angeles County, California",Census Tract 6019,1346,290,1056,607700
06037602002,"Census Tract 6020.02, Los Angeles County, California",Census Tract 6020.02,826,250,576,598800
06037602003,"Census Tract 6020.03, Los Angeles County, California",Census Tract 6020.03,1209,415,794,539600
06037602103,"Census Tract 6021.03, Los Angeles County, California",Census Tract 6021.03,1768,367,1401,587000
06037602104,"Census Tract 6021.04, Los Angeles County, California",Census Tract 6021.04,1813,404,1409,574400
06037602105,"Census Tract 6021.05, Los Angeles County, California",Census Tract 6021.05,1362,211,1151,576000
06037602106,"Census Tract 6021.06, Los Angeles County, California",Census Tract 6021.06,2242,336,1906,583300
06037602201,"Census Tract 6022.01, Los Angeles County, California",Census Tract 6022.01,1601,874,727,857400
06037602202,"Census Tract 6022.02, Los Angeles County, California",Census Tract 6022.02,940,382,558,634600
06037602301,"Census Tract 6023.01, Los Angeles County, California",Census Tract 6023.01,1901,1364,537,696300
06037602302,"Census Tract 6023.02, Los Angeles County, California",Census Tract 6023.02,1745,1421,324,898400
06037602402,"Census Tract 6024.02, Los Angeles County, California",Census Tract 6024.02,1957,892,1065,665600
06037602403,"Census Tract 6024.03, Los Angeles County, California",Census Tract 6024.03,1531,318,1213,580500
06037602404,"Census Tract 6024.04, Los Angeles County, California",Census Tract 6024.04,1836,420,1416,708100
06037602504,"Census Tract 6025.04, Los Angeles County, California",Census Tract 6025.04,1850,189,1661,618000
06037602505,"Census Tract 6025.05, Los Angeles County, California",Census Tract 6025.05,1596,90,1506,574200
06037602506,"Census Tract 6025.06, Los Angeles County, California",Census Tract 6025.06,1717,208,1509,496200
06037602507,"Census Tract 6025.07, Los Angeles County, California",Census Tract 6025.07,1902,199,1703,451200
06037602510,"Census Tract 6025.10, Los Angeles County, California",Census Tract 6025.10,1108,120,988,480000
06037602511,"Census Tract 6025.11, Los Angeles County, California",Census Tract 6025.11,1524,105,1419,711700
06037602512,"Census Tract 6025.12, Los Angeles County, California",Census Tract 6025.12,547,304,243,590300
06037602513,"Census Tract 6025.13, Los Angeles County, California",Census Tract 6025.13,472,79,393,635900
06037602601,"Census Tract 6026.01, Los Angeles County, California",Census Tract 6026.01,1655,1033,622,558100
06037602602,"Census Tract 6026.02, Los Angeles County, California",Census Tract 6026.02,1168,553,615,578000
06037602700,"Census Tract 6027, Los Angeles County, California",Census Tract 6027,1252,1069,183,613200
06037602801,"Census Tract 6028.01, Los Angeles County, California",Census Tract 6028.01,1294,439,855,446400
06037602802,"Census Tract 6028.02, Los Angeles County, California",Census Tract 6028.02,1295,1127,168,537000
06037602900,"Census Tract 6029, Los Angeles County, California",Census Tract 6029,1374,641,733,443800
06037603004,"Census Tract 6030.04, Los Angeles County, California",Census Tract 6030.04,645,143,502,369000
06037603005,"Census Tract 6030.05, Los Angeles County, California",Census Tract 6030.05,2004,600,1404,433900
06037603006,"Census Tract 6030.06, Los Angeles County, California",Census Tract 6030.06,817,420,397,576200
06037603007,"Census Tract 6030.07, Los Angeles County, California",Census Tract 6030.07,1188,479,709,609600
06037603008,"Census Tract 6030.08, Los Angeles County, California",Census Tract 6030.08,1195,380,815,516400
06037603101,"Census Tract 6031.01, Los Angeles County, California",Census Tract 6031.01,1548,519,1029,561800
06037603102,"Census Tract 6031.02, Los Angeles County, California",Census Tract 6031.02,1243,280,963,521200
06037603200,"Census Tract 6032, Los Angeles County, California",Census Tract 6032,1229,862,367,575800
06037603301,"Census Tract 6033.01, Los Angeles County, California",Census Tract 6033.01,1382,497,885,643500
06037603302,"Census Tract 6033.02, Los Angeles County, California",Census Tract 6033.02,1605,937,668,602300
06037603400,"Census Tract 6034, Los Angeles County, California",Census Tract 6034,1447,931,516,576200
06037603500,"Census Tract 6035, Los Angeles County, California",Census Tract 6035,889,722,167,580900
06037603600,"Census Tract 6036, Los Angeles County, California",Census Tract 6036,1417,1044,373,601200
06037603702,"Census Tract 6037.02, Los Angeles County, California",Census Tract 6037.02,1667,1457,210,630900
06037603703,"Census Tract 6037.03, Los Angeles County, California",Census Tract 6037.03,845,769,76,632200
06037603705,"Census Tract 6037.05, Los Angeles County, California",Census Tract 6037.05,944,351,593,351800
06037603706,"Census Tract 6037.06, Los Angeles County, California",Census Tract 6037.06,1048,13,1035,
06037603801,"Census Tract 6038.01, Los Angeles County, California",Census Tract 6038.01,1542,567,975,654800
06037603802,"Census Tract 6038.02, Los Angeles County, California",Census Tract 6038.02,1166,541,625,588000
06037603901,"Census Tract 6039.01, Los Angeles County, California",Census Tract 6039.01,1260,636,624,502900
06037603902,"Census Tract 6039.02, Los Angeles County, California",Census Tract 6039.02,1128,558,570,565600
06037604001,"Census Tract 6040.01, Los Angeles County, California",Census Tract 6040.01,1200,419,781,543700
06037604002,"Census Tract 6040.02, Los Angeles County, California",Census Tract 6040.02,1431,422,1009,634600
06037604101,"Census Tract 6041.01, Los Angeles County, California",Census Tract 6041.01,1167,287,880,633500
06037604102,"Census Tract 6041.02, Los Angeles County, California",Census Tract 6041.02,832,347,485,608100
06037604200,"Census Tract 6042, Los Angeles County, California",Census Tract 6042,1648,797,851,584300
06037609900,"Census Tract 6099, Los Angeles County, California",Census Tract 6099,634,327,307,650700
06037620001,"Census Tract 6200.01, Los Angeles County, California",Census Tract 6200.01,1630,785,845,1401100
06037620002,"Census Tract 6200.02, Los Angeles County, California",Census Tract 6200.02,1515,550,965,1127400
06037620101,"Census Tract 6201.01, Los Angeles County, California",Census Tract 6201.01,2163,1138,1025,1133700
06037620102,"Census Tract 6201.02, Los Angeles County, California",Census Tract 6201.02,1762,496,1266,1532100
06037620201,"Census Tract 6202.01, Los Angeles County, California",Census Tract 6202.01,924,286,638,1762200
06037620301,"Census Tract 6203.01, Los Angeles County, California",Census Tract 6203.01,1515,1289,226,2000001
06037620303,"Census Tract 6203.03, Los Angeles County, California",Census Tract 6203.03,1810,1228,582,2000001
06037620305,"Census Tract 6203.05, Los Angeles County, California",Census Tract 6203.05,2432,1353,1079,2000001
06037620400,"Census Tract 6204, Los Angeles County, California",Census Tract 6204,1933,1464,469,1584800
06037620501,"Census Tract 6205.01, Los Angeles County, California",Census Tract 6205.01,2193,1298,895,1083800
06037620521,"Census Tract 6205.21, Los Angeles County, California",Census Tract 6205.21,1795,802,993,916400
06037620522,"Census Tract 6205.22, Los Angeles County, California",Census Tract 6205.22,1859,1010,849,1004400
06037620601,"Census Tract 6206.01, Los Angeles County, California",Census Tract 6206.01,2233,996,1237,872100
06037620602,"Census Tract 6206.02, Los Angeles County, California",Census Tract 6206.02,1992,1594,398,877500
06037620701,"Census Tract 6207.01, Los Angeles County, California",Census Tract 6207.01,2948,1668,1280,1036000
06037620703,"Census Tract 6207.03, Los Angeles County, California",Census Tract 6207.03,1282,1038,244,1140500
06037620704,"Census Tract 6207.04, Los Angeles County, California",Census Tract 6207.04,1181,838,343,1053600
06037620801,"Census Tract 6208.01, Los Angeles County, California",Census Tract 6208.01,1331,1147,184,1915500
06037620802,"Census Tract 6208.02, Los Angeles County, California",Census Tract 6208.02,1308,740,568,2000001
06037620901,"Census Tract 6209.01, Los Angeles County, California",Census Tract 6209.01,1083,907,176,2000001
06037620904,"Census Tract 6209.04, Los Angeles County, California",Census Tract 6209.04,1086,682,404,2000001
06037621001,"Census Tract 6210.01, Los Angeles County, California",Census Tract 6210.01,2018,1097,921,1565600
06037621005,"Census Tract 6210.05, Los Angeles County, California",Census Tract 6210.05,2460,1330,1130,2000001
06037621102,"Census Tract 6211.02, Los Angeles County, California",Census Tract 6211.02,1231,826,405,1239100
06037621104,"Census Tract 6211.04, Los Angeles County, California",Census Tract 6211.04,3217,1282,1935,1693000
06037621201,"Census Tract 6212.01, Los Angeles County, California",Census Tract 6212.01,2940,1619,1321,981200
06037621204,"Census Tract 6212.04, Los Angeles County, California",Census Tract 6212.04,1808,577,1231,888000
06037621301,"Census Tract 6213.01, Los Angeles County, California",Census Tract 6213.01,2873,1848,1025,1138200
06037621324,"Census Tract 6213.24, Los Angeles County, California",Census Tract 6213.24,1995,690,1305,977200
06037621326,"Census Tract 6213.26, Los Angeles County, California",Census Tract 6213.26,1788,401,1387,1904400
06037621400,"Census Tract 6214, Los Angeles County, California",Census Tract 6214,1889,858,1031,1237100
06037650001,"Census Tract 6500.01, Los Angeles County, California",Census Tract 6500.01,2199,1465,734,714100
06037650003,"Census Tract 6500.03, Los Angeles County, California",Census Tract 6500.03,1156,404,752,781400
06037650004,"Census Tract 6500.04, Los Angeles County, California",Census Tract 6500.04,1547,725,822,677000
06037650101,"Census Tract 6501.01, Los Angeles County, California",Census Tract 6501.01,2140,1562,578,771900
06037650102,"Census Tract 6501.02, Los Angeles County, California",Census Tract 6501.02,725,516,209,687900
06037650200,"Census Tract 6502, Los Angeles County, California",Census Tract 6502,1835,1418,417,690500
06037650300,"Census Tract 6503, Los Angeles County, California",Census Tract 6503,2520,1153,1367,683500
06037650401,"Census Tract 6504.01, Los Angeles County, California",Census Tract 6504.01,1488,1255,233,859200
06037650501,"Census Tract 6505.01, Los Angeles County, California",Census Tract 6505.01,981,834,147,922500
06037650502,"Census Tract 6505.02, Los Angeles County, California",Census Tract 6505.02,1555,1171,384,941500
06037650603,"Census Tract 6506.03, Los Angeles County, California",Census Tract 6506.03,1516,1014,502,1051500
06037650604,"Census Tract 6506.04, Los Angeles County, California",Census Tract 6506.04,2645,181,2464,694600
06037650605,"Census Tract 6506.05, Los Angeles County, California",Census Tract 6506.05,1023,305,718,846100
06037650606,"Census Tract 6506.06, Los Angeles County, California",Census Tract 6506.06,1772,170,1602,760000
06037650607,"Census Tract 6506.07, Los Angeles County, California",Census Tract 6506.07,1089,361,728,854200
06037650701,"Census Tract 6507.01, Los Angeles County, California",Census Tract 6507.01,963,809,154,859200
06037650702,"Census Tract 6507.02, Los Angeles County, California",Census Tract 6507.02,1625,1350,275,884100
06037650801,"Census Tract 6508.01, Los Angeles County, California",Census Tract 6508.01,1639,1079,560,692100
06037650802,"Census Tract 6508.02, Los Angeles County, California",Census Tract 6508.02,1317,821,496,585100
06037650901,"Census Tract 6509.01, Los Angeles County, California",Census Tract 6509.01,2261,989,1272,721900
06037650903,"Census Tract 6509.03, Los Angeles County, California",Census Tract 6509.03,1771,690,1081,695100
06037650904,"Census Tract 6509.04, Los Angeles County, California",Census Tract 6509.04,962,558,404,709900
06037651001,"Census Tract 6510.01, Los Angeles County, California",Census Tract 6510.01,1885,1505,380,815300
06037651002,"Census Tract 6510.02, Los Angeles County, California",Census Tract 6510.02,1759,1000,759,870300
06037651101,"Census Tract 6511.01, Los Angeles County, California",Census Tract 6511.01,1764,970,794,938900
06037651102,"Census Tract 6511.02, Los Angeles County, California",Census Tract 6511.02,1720,971,749,702900
06037651201,"Census Tract 6512.01, Los Angeles County, California",Census Tract 6512.01,1725,1463,262,994100
06037651221,"Census Tract 6512.21, Los Angeles County, California",Census Tract 6512.21,1466,494,972,917600
06037651222,"Census Tract 6512.22, Los Angeles County, California",Census Tract 6512.22,2414,719,1695,899700
06037651302,"Census Tract 6513.02, Los Angeles County, California",Census Tract 6513.02,2234,1622,612,1304200
06037651304,"Census Tract 6513.04, Los Angeles County, California",Census Tract 6513.04,2470,1208,1262,1341300
06037651401,"Census Tract 6514.01, Los Angeles County, California",Census Tract 6514.01,1232,695,537,849000
06037651402,"Census Tract 6514.02, Los Angeles County, California",Census Tract 6514.02,2187,1182,1005,912400
06037670001,"Census Tract 6700.01, Los Angeles County, California",Census Tract 6700.01,1295,808,487,656900
06037670002,"Census Tract 6700.02, Los Angeles County, California",Census Tract 6700.02,1420,525,895,659400
06037670003,"Census Tract 6700.03, Los Angeles County, California",Census Tract 6700.03,2363,1132,1231,640300
06037670101,"Census Tract 6701.01, Los Angeles County, California",Census Tract 6701.01,1211,571,640,694700
06037670102,"Census Tract 6701.02, Los Angeles County, California",Census Tract 6701.02,1572,414,1158,474200
06037670201,"Census Tract 6702.01, Los Angeles County, California",Census Tract 6702.01,1372,1185,187,1607500
06037670202,"Census Tract 6702.02, Los Angeles County, California",Census Tract 6702.02,783,744,39,1516400
06037670324,"Census Tract 6703.24, Los Angeles County, California",Census Tract 6703.24,2077,1795,282,1762600
06037670326,"Census Tract 6703.26, Los Angeles County, California",Census Tract 6703.26,1257,1188,69,2000001
06037670328,"Census Tract 6703.28, Los Angeles County, California",Census Tract 6703.28,1575,1356,219,2000001
06037670405,"Census Tract 6704.05, Los Angeles County, California",Census Tract 6704.05,1056,824,232,1127200
06037670406,"Census Tract 6704.06, Los Angeles County, California",Census Tract 6704.06,591,544,47,1730400
06037670407,"Census Tract 6704.07, Los Angeles County, California",Census Tract 6704.07,2364,1282,1082,939500
06037670413,"Census Tract 6704.13, Los Angeles County, California",Census Tract 6704.13,1616,1260,356,1270700
06037670416,"Census Tract 6704.16, Los Angeles County, California",Census Tract 6704.16,1594,902,692,1775800
06037670417,"Census Tract 6704.17, Los Angeles County, California",Census Tract 6704.17,1030,920,110,1211200
06037670418,"Census Tract 6704.18, Los Angeles County, California",Census Tract 6704.18,1500,1371,129,1244200
06037670500,"Census Tract 6705, Los Angeles County, California",Census Tract 6705,546,511,35,2000001
06037670603,"Census Tract 6706.03, Los Angeles County, California",Census Tract 6706.03,612,545,67,2000001
06037670604,"Census Tract 6706.04, Los Angeles County, California",Census Tract 6706.04,2141,1821,320,1326000
06037670701,"Census Tract 6707.01, Los Angeles County, California",Census Tract 6707.01,2206,1977,229,896700
06037670702,"Census Tract 6707.02, Los Angeles County, California",Census Tract 6707.02,2039,1901,138,1497600
06037700101,"Census Tract 7001.01, Los Angeles County, California",Census Tract 7001.01,3484,156,3328,1537200
06037700102,"Census Tract 7001.02, Los Angeles County, California",Census Tract 7001.02,2832,96,2736,1166700
06037700200,"Census Tract 7002, Los Angeles County, California",Census Tract 7002,4319,424,3895,845500
06037700300,"Census Tract 7003, Los Angeles County, California",Census Tract 7003,3965,1299,2666,683000
06037700400,"Census Tract 7004, Los Angeles County, California",Census Tract 7004,2973,654,2319,1355600
06037700501,"Census Tract 7005.01, Los Angeles County, California",Census Tract 7005.01,2523,989,1534,959100
06037700502,"Census Tract 7005.02, Los Angeles County, California",Census Tract 7005.02,2888,950,1938,658400
06037700600,"Census Tract 7006, Los Angeles County, California",Census Tract 7006,1751,1568,183,2000001
06037700700,"Census Tract 7007, Los Angeles County, California",Census Tract 7007,1167,1035,132,2000001
06037700801,"Census Tract 7008.01, Los Angeles County, California",Census Tract 7008.01,2202,873,1329,1342200
06037700802,"Census Tract 7008.02, Los Angeles County, California",Census Tract 7008.02,2036,556,1480,1625000
06037700901,"Census Tract 7009.01, Los Angeles County, California",Census Tract 7009.01,1448,617,831,2000001
06037700902,"Census Tract 7009.02, Los Angeles County, California",Census Tract 7009.02,3256,617,2639,2000001
06037701000,"Census Tract 7010, Los Angeles County, California",Census Tract 7010,2541,738,1803,2000001
06037701201,"Census Tract 7012.01, Los Angeles County, California",Census Tract 7012.01,1492,1252,240,2000001
06037701202,"Census Tract 7012.02, Los Angeles County, California",Census Tract 7012.02,1761,735,1026,1578400
06037701302,"Census Tract 7013.02, Los Angeles County, California",Census Tract 7013.02,2851,633,2218,909700
06037701304,"Census Tract 7013.04, Los Angeles County, California",Census Tract 7013.04,2927,1679,1248,2000001
06037701402,"Census Tract 7014.02, Los Angeles County, California",Census Tract 7014.02,3712,452,3260,1719400
06037701501,"Census Tract 7015.01, Los Angeles County, California",Census Tract 7015.01,2649,477,2172,1129000
06037701502,"Census Tract 7015.02, Los Angeles County, California",Census Tract 7015.02,1952,291,1661,900200
06037701601,"Census Tract 7016.01, Los Angeles County, California",Census Tract 7016.01,1781,996,785,2000001
06037701602,"Census Tract 7016.02, Los Angeles County, California",Census Tract 7016.02,1948,641,1307,960600
06037701701,"Census Tract 7017.01, Los Angeles County, California",Census Tract 7017.01,1804,448,1356,834400
06037701702,"Census Tract 7017.02, Los Angeles County, California",Census Tract 7017.02,1701,160,1541,1004000
06037701801,"Census Tract 7018.01, Los Angeles County, California",Census Tract 7018.01,2843,551,2292,819300
06037701802,"Census Tract 7018.02, Los Angeles County, California",Census Tract 7018.02,2080,382,1698,1097700
06037701902,"Census Tract 7019.02, Los Angeles County, California",Census Tract 7019.02,3153,100,3053,2000001
06037702002,"Census Tract 7020.02, Los Angeles County, California",Census Tract 7020.02,3453,662,2791,1050300
06037702102,"Census Tract 7021.02, Los Angeles County, California",Census Tract 7021.02,3739,755,2984,1371800
06037702201,"Census Tract 7022.01, Los Angeles County, California",Census Tract 7022.01,2104,804,1300,1156000
06037702202,"Census Tract 7022.02, Los Angeles County, California",Census Tract 7022.02,1793,883,910,1678300
06037702300,"Census Tract 7023, Los Angeles County, California",Census Tract 7023,2917,1415,1502,1666200
06037702400,"Census Tract 7024, Los Angeles County, California",Census Tract 7024,2103,686,1417,1211100
06037702501,"Census Tract 7025.01, Los Angeles County, California",Census Tract 7025.01,2275,1166,1109,1392600
06037702502,"Census Tract 7025.02, Los Angeles County, California",Census Tract 7025.02,2272,1567,705,564300
06037702600,"Census Tract 7026, Los Angeles County, California",Census Tract 7026,2686,2161,525,1059700
06037702700,"Census Tract 7027, Los Angeles County, California",Census Tract 7027,1335,1034,301,1199700
06037702801,"Census Tract 7028.01, Los Angeles County, California",Census Tract 7028.01,2027,936,1091,1090700
06037702802,"Census Tract 7028.02, Los Angeles County, California",Census Tract 7028.02,1048,357,691,1112300
06037702803,"Census Tract 7028.03, Los Angeles County, California",Census Tract 7028.03,1195,355,840,1239000
06037702900,"Census Tract 7029, Los Angeles County, California",Census Tract 7029,5202,412,4790,684600
06037703002,"Census Tract 7030.02, Los Angeles County, California",Census Tract 7030.02,2779,1864,915,1173200
06037703003,"Census Tract 7030.03, Los Angeles County, California",Census Tract 7030.03,3203,1548,1655,558600
06037703100,"Census Tract 7031, Los Angeles County, California",Census Tract 7031,2664,1869,795,864700
06037703200,"Census Tract 7032, Los Angeles County, California",Census Tract 7032,2193,1612,581,878400
06037800101,"Census Tract 8001.01, Los Angeles County, California",Census Tract 8001.01,1925,1769,156,1134000
06037800103,"Census Tract 8001.03, Los Angeles County, California",Census Tract 8001.03,1173,887,286,1052400
06037800104,"Census Tract 8001.04, Los Angeles County, California",Census Tract 8001.04,1353,987,366,1429200
06037800202,"Census Tract 8002.02, Los Angeles County, California",Census Tract 8002.02,2035,1747,288,1561400
06037800204,"Census Tract 8002.04, Los Angeles County, California",Census Tract 8002.04,1756,1338,418,1333300
06037800205,"Census Tract 8002.05, Los Angeles County, California",Census Tract 8002.05,1605,579,1026,754200
06037800206,"Census Tract 8002.06, Los Angeles County, California",Census Tract 8002.06,1137,1043,94,2000001
06037800324,"Census Tract 8003.24, Los Angeles County, California",Census Tract 8003.24,2557,2240,317,757800
06037800325,"Census Tract 8003.25, Los Angeles County, California",Census Tract 8003.25,1350,1124,226,1058100
06037800328,"Census Tract 8003.28, Los Angeles County, California",Census Tract 8003.28,369,328,41,1171900
06037800333,"Census Tract 8003.33, Los Angeles County, California",Census Tract 8003.33,972,318,654,471200
06037800334,"Census Tract 8003.34, Los Angeles County, California",Census Tract 8003.34,1271,1106,165,826100
06037800335,"Census Tract 8003.35, Los Angeles County, California",Census Tract 8003.35,1879,1573,306,1158200
06037800336,"Census Tract 8003.36, Los Angeles County, California",Census Tract 8003.36,1199,1121,78,992300
06037800337,"Census Tract 8003.37, Los Angeles County, California",Census Tract 8003.37,1750,699,1051,805900
06037800338,"Census Tract 8003.38, Los Angeles County, California",Census Tract 8003.38,2153,1781,372,1158600
06037800406,"Census Tract 8004.06, Los Angeles County, California",Census Tract 8004.06,836,640,196,2000001
06037800410,"Census Tract 8004.10, Los Angeles County, California",Census Tract 8004.10,468,387,81,1532900
06037800411,"Census Tract 8004.11, Los Angeles County, California",Census Tract 8004.11,1069,921,148,2000001
06037800412,"Census Tract 8004.12, Los Angeles County, California",Census Tract 8004.12,1422,1209,213,1808300
06037800504,"Census Tract 8005.04, Los Angeles County, California",Census Tract 8005.04,965,559,406,2000001
06037800506,"Census Tract 8005.06, Los Angeles County, California",Census Tract 8005.06,1364,1088,276,2000000
06037900102,"Census Tract 9001.02, Los Angeles County, California",Census Tract 9001.02,279,173,106,209800
06037900103,"Census Tract 9001.03, Los Angeles County, California",Census Tract 9001.03,1696,1035,661,227800
06037900104,"Census Tract 9001.04, Los Angeles County, California",Census Tract 9001.04,1780,1346,434,201400
06037900301,"Census Tract 9003.01, Los Angeles County, California",Census Tract 9003.01,1014,653,361,270200
06037900501,"Census Tract 9005.01, Los Angeles County, California",Census Tract 9005.01,2104,1372,732,241400
06037900504,"Census Tract 9005.04, Los Angeles County, California",Census Tract 9005.04,1991,1192,799,297900
06037900505,"Census Tract 9005.05, Los Angeles County, California",Census Tract 9005.05,1283,812,471,300300
06037900506,"Census Tract 9005.06, Los Angeles County, California",Census Tract 9005.06,1468,829,639,272700
06037900508,"Census Tract 9005.08, Los Angeles County, California",Census Tract 9005.08,1066,777,289,306500
06037900509,"Census Tract 9005.09, Los Angeles County, California",Census Tract 9005.09,1309,666,643,105700
06037900510,"Census Tract 9005.10, Los Angeles County, California",Census Tract 9005.10,1074,472,602,248000
06037900602,"Census Tract 9006.02, Los Angeles County, California",Census Tract 9006.02,1756,1132,624,45600
06037900606,"Census Tract 9006.06, Los Angeles County, California",Census Tract 9006.06,1456,383,1073,229500
06037900607,"Census Tract 9006.07, Los Angeles County, California",Census Tract 9006.07,1234,666,568,236300
06037900608,"Census Tract 9006.08, Los Angeles County, California",Census Tract 9006.08,1167,787,380,279500
06037900609,"Census Tract 9006.09, Los Angeles County, California",Census Tract 9006.09,1505,707,798,255500
06037900610,"Census Tract 9006.10, Los Angeles County, California",Census Tract 9006.10,1219,909,310,55400
06037900611,"Census Tract 9006.11, Los Angeles County, California",Census Tract 9006.11,1166,771,395,242800
06037900701,"Census Tract 9007.01, Los Angeles County, California",Census Tract 9007.01,1570,643,927,236100
06037900703,"Census Tract 9007.03, Los Angeles County, California",Census Tract 9007.03,2179,360,1819,219800
06037900704,"Census Tract 9007.04, Los Angeles County, California",Census Tract 9007.04,1595,32,1563,
06037900705,"Census Tract 9007.05, Los Angeles County, California",Census Tract 9007.05,1860,644,1216,296500
06037900804,"Census Tract 9008.04, Los Angeles County, California",Census Tract 9008.04,1106,455,651,218500
06037900805,"Census Tract 9008.05, Los Angeles County, California",Census Tract 9008.05,1597,1168,429,254300
06037900806,"Census Tract 9008.06, Los Angeles County, California",Census Tract 9008.06,2189,225,1964,191200
06037900807,"Census Tract 9008.07, Los Angeles County, California",Census Tract 9008.07,1145,730,415,325000
06037900808,"Census Tract 9008.08, Los Angeles County, California",Census Tract 9008.08,1394,791,603,263600
06037900901,"Census Tract 9009.01, Los Angeles County, California",Census Tract 9009.01,917,485,432,303100
06037900902,"Census Tract 9009.02, Los Angeles County, California",Census Tract 9009.02,606,472,134,347900
06037901003,"Census Tract 9010.03, Los Angeles County, California",Census Tract 9010.03,0,0,0,
06037901007,"Census Tract 9010.07, Los Angeles County, California",Census Tract 9010.07,707,560,147,371200
06037901008,"Census Tract 9010.08, Los Angeles County, California",Census Tract 9010.08,1054,462,592,308700
06037901009,"Census Tract 9010.09, Los Angeles County, California",Census Tract 9010.09,1867,1279,588,376500
06037901010,"Census Tract 9010.10, Los Angeles County, California",Census Tract 9010.10,1878,1069,809,351100
06037901011,"Census Tract 9010.11, Los Angeles County, California",Census Tract 9010.11,2122,1008,1114,327100
06037901012,"Census Tract 9010.12, Los Angeles County, California",Census Tract 9010.12,1706,1340,366,421700
06037901013,"Census Tract 9010.13, Los Angeles County, California",Census Tract 9010.13,1207,990,217,391500
06037901014,"Census Tract 9010.14, Los Angeles County, California",Census Tract 9010.14,1548,1198,350,353700
06037901101,"Census Tract 9011.01, Los Angeles County, California",Census Tract 9011.01,1799,1231,568,361700
06037901102,"Census Tract 9011.02, Los Angeles County, California",Census Tract 9011.02,1862,1361,501,355800
06037901209,"Census Tract 9012.09, Los Angeles County, California",Census Tract 9012.09,450,325,125,299400
06037901210,"Census Tract 9012.10, Los Angeles County, California",Census Tract 9012.10,653,550,103,315800
06037901214,"Census Tract 9012.14, Los Angeles County, California",Census Tract 9012.14,1545,1170,375,363600
06037901215,"Census Tract 9012.15, Los Angeles County, California",Census Tract 9012.15,1491,771,720,439900
06037901216,"Census Tract 9012.16, Los Angeles County, California",Census Tract 9012.16,798,746,52,455500
06037901217,"Census Tract 9012.17, Los Angeles County, California",Census Tract 9012.17,602,549,53,523800
06037901218,"Census Tract 9012.18, Los Angeles County, California",Census Tract 9012.18,754,747,7,556900
06037901300,"Census Tract 9013, Los Angeles County, California",Census Tract 9013,571,351,220,279300
06037910002,"Census Tract 9100.02, Los Angeles County, California",Census Tract 9100.02,1990,1277,713,251900
06037910210,"Census Tract 9102.10, Los Angeles County, California",Census Tract 9102.10,2281,1944,337,429000
06037910211,"Census Tract 9102.11, Los Angeles County, California",Census Tract 9102.11,444,372,72,660000
06037910212,"Census Tract 9102.12, Los Angeles County, California",Census Tract 9102.12,1013,745,268,493400
06037910213,"Census Tract 9102.13, Los Angeles County, California",Census Tract 9102.13,490,370,120,506300
06037910214,"Census Tract 9102.14, Los Angeles County, California",Census Tract 9102.14,1613,1179,434,389100
06037910215,"Census Tract 9102.15, Los Angeles County, California",Census Tract 9102.15,2041,1439,602,336700
06037910216,"Census Tract 9102.16, Los Angeles County, California",Census Tract 9102.16,1437,1180,257,406900
06037910217,"Census Tract 9102.17, Los Angeles County, California",Census Tract 9102.17,1514,1239,275,423900
06037910218,"Census Tract 9102.18, Los Angeles County, California",Census Tract 9102.18,1491,867,624,331400
06037910301,"Census Tract 9103.01, Los Angeles County, California",Census Tract 9103.01,1559,1172,387,420700
06037910302,"Census Tract 9103.02, Los Angeles County, California",Census Tract 9103.02,2012,1701,311,363900
06037910401,"Census Tract 9104.01, Los Angeles County, California",Census Tract 9104.01,1972,963,1009,353800
06037910404,"Census Tract 9104.04, Los Angeles County, California",Census Tract 9104.04,1187,652,535,303800
06037910405,"Census Tract 9104.05, Los Angeles County, California",Census Tract 9104.05,1718,356,1362,250800
06037910501,"Census Tract 9105.01, Los Angeles County, California",Census Tract 9105.01,2067,67,2000,187500
06037910502,"Census Tract 9105.02, Los Angeles County, California",Census Tract 9105.02,1359,478,881,259400
06037910504,"Census Tract 9105.04, Los Angeles County, California",Census Tract 9105.04,1200,698,502,263500
06037910505,"Census Tract 9105.05, Los Angeles County, California",Census Tract 9105.05,854,669,185,286600
06037910601,"Census Tract 9106.01, Los Angeles County, California",Census Tract 9106.01,1722,1173,549,238000
06037910602,"Census Tract 9106.02, Los Angeles County, California",Census Tract 9106.02,1429,576,853,
06037910605,"Census Tract 9106.05, Los Angeles County, California",Census Tract 9106.05,1327,901,426,236400
06037910606,"Census Tract 9106.06, Los Angeles County, California",Census Tract 9106.06,764,487,277,277900
06037910607,"Census Tract 9106.07, Los Angeles County, California",Census Tract 9106.07,1179,661,518,323000
06037910608,"Census Tract 9106.08, Los Angeles County, California",Census Tract 9106.08,1026,656,370,293300
06037910706,"Census Tract 9107.06, Los Angeles County, California",Census Tract 9107.06,1658,1248,410,338600
06037910707,"Census Tract 9107.07, Los Angeles County, California",Census Tract 9107.07,1458,860,598,328400
06037910709,"Census Tract 9107.09, Los Angeles County, California",Census Tract 9107.09,487,453,34,415400
06037910712,"Census Tract 9107.12, Los Angeles County, California",Census Tract 9107.12,817,671,146,330200
06037910713,"Census Tract 9107.13, Los Angeles County, California",Census Tract 9107.13,1618,1192,426,306300
06037910714,"Census Tract 9107.14, Los Angeles County, California",Census Tract 9107.14,1003,730,273,283500
06037910715,"Census Tract 9107.15, Los Angeles County, California",Census Tract 9107.15,1898,1491,407,272000
06037910716,"Census Tract 9107.16, Los Angeles County, California",Census Tract 9107.16,1801,1367,434,317100
06037910717,"Census Tract 9107.17, Los Angeles County, California",Census Tract 9107.17,597,574,23,340400
06037910718,"Census Tract 9107.18, Los Angeles County, California",Census Tract 9107.18,1289,1085,204,340500
06037910719,"Census Tract 9107.19, Los Angeles County, California",Census Tract 9107.19,978,675,303,335800
06037910720,"Census Tract 9107.20, Los Angeles County, California",Census Tract 9107.20,1545,980,565,263700
06037910721,"Census Tract 9107.21, Los Angeles County, California",Census Tract 9107.21,1049,489,560,340200
06037910804,"Census Tract 9108.04, Los Angeles County, California",Census Tract 9108.04,1041,939,102,626000
06037910807,"Census Tract 9108.07, Los Angeles County, California",Census Tract 9108.07,1883,1563,320,580100
06037910808,"Census Tract 9108.08, Los Angeles County, California",Census Tract 9108.08,1142,1092,50,579200
06037910809,"Census Tract 9108.09, Los Angeles County, California",Census Tract 9108.09,696,690,6,1068300
06037910810,"Census Tract 9108.10, Los Angeles County, California",Census Tract 9108.10,756,661,95,648800
06037910814,"Census Tract 9108.14, Los Angeles County, California",Census Tract 9108.14,1261,1188,73,634400
06037910815,"Census Tract 9108.15, Los Angeles County, California",Census Tract 9108.15,1675,1494,181,540500
06037911001,"Census Tract 9110.01, Los Angeles County, California",Census Tract 9110.01,1405,1191,214,292900
06037911100,"Census Tract 9111, Los Angeles County, California",Census Tract 9111,2030,1275,755,278400
06037920013,"Census Tract 9200.13, Los Angeles County, California",Census Tract 9200.13,2317,2012,305,576500
06037920015,"Census Tract 9200.15, Los Angeles County, California",Census Tract 9200.15,2210,1997,213,666300
06037920016,"Census Tract 9200.16, Los Angeles County, California",Census Tract 9200.16,1288,1074,214,750500
06037920017,"Census Tract 9200.17, Los Angeles County, California",Census Tract 9200.17,1328,1097,231,583300
06037920018,"Census Tract 9200.18, Los Angeles County, California",Census Tract 9200.18,712,652,60,603100
06037920020,"Census Tract 9200.20, Los Angeles County, California",Census Tract 9200.20,1862,1674,188,588600
06037920028,"Census Tract 9200.28, Los Angeles County, California",Census Tract 9200.28,2515,2234,281,567800
06037920029,"Census Tract 9200.29, Los Angeles County, California",Census Tract 9200.29,1861,1238,623,376200
06037920030,"Census Tract 9200.30, Los Angeles County, California",Census Tract 9200.30,1571,1318,253,573900
06037920031,"Census Tract 9200.31, Los Angeles County, California",Census Tract 9200.31,2383,2148,235,399500
06037920034,"Census Tract 9200.34, Los Angeles County, California",Census Tract 9200.34,1094,909,185,572500
06037920035,"Census Tract 9200.35, Los Angeles County, California",Census Tract 9200.35,2468,1691,777,412500
06037920038,"Census Tract 9200.38, Los Angeles County, California",Census Tract 9200.38,593,158,435,300000
06037920039,"Census Tract 9200.39, Los Angeles County, California",Census Tract 9200.39,518,459,59,635100
06037920040,"Census Tract 9200.40, Los Angeles County, California",Census Tract 9200.40,1033,850,183,579000
06037920041,"Census Tract 9200.41, Los Angeles County, California",Census Tract 9200.41,784,186,598,467300
06037920042,"Census Tract 9200.42, Los Angeles County, California",Census Tract 9200.42,2389,1415,974,442100
06037920043,"Census Tract 9200.43, Los Angeles County, California",Census Tract 9200.43,2336,1864,472,702600
06037920044,"Census Tract 9200.44, Los Angeles County, California",Census Tract 9200.44,845,704,141,576900
06037920045,"Census Tract 9200.45, Los Angeles County, California",Census Tract 9200.45,1441,1274,167,612700
06037920046,"Census Tract 9200.46, Los Angeles County, California",Census Tract 9200.46,1427,764,663,324500
06037920047,"Census Tract 9200.47, Los Angeles County, California",Census Tract 9200.47,2061,234,1827,64300
06037920048,"Census Tract 9200.48, Los Angeles County, California",Census Tract 9200.48,1796,1353,443,459800
06037920049,"Census Tract 9200.49, Los Angeles County, California",Census Tract 9200.49,1584,1501,83,672000
06037920050,"Census Tract 9200.50, Los Angeles County, California",Census Tract 9200.50,484,374,110,296700
06037920102,"Census Tract 9201.02, Los Angeles County, California",Census Tract 9201.02,1574,985,589,457400
06037920104,"Census Tract 9201.04, Los Angeles County, California",Census Tract 9201.04,819,736,83,634200
06037920106,"Census Tract 9201.06, Los Angeles County, California",Census Tract 9201.06,1019,870,149,410500
06037920109,"Census Tract 9201.09, Los Angeles County, California",Census Tract 9201.09,1919,1435,484,611700
06037920110,"Census Tract 9201.10, Los Angeles County, California",Census Tract 9201.10,1011,652,359,792700
06037920111,"Census Tract 9201.11, Los Angeles County, California",Census Tract 9201.11,1050,919,131,582200
06037920112,"Census Tract 9201.12, Los Angeles County, California",Census Tract 9201.12,1535,1103,432,639200
06037920114,"Census Tract 9201.14, Los Angeles County, California",Census Tract 9201.14,2288,1291,997,616400
06037920115,"Census Tract 9201.15, Los Angeles County, California",Census Tract 9201.15,1743,943,800,637700
06037920116,"Census Tract 9201.16, Los Angeles County, California",Census Tract 9201.16,1572,1439,133,581000
06037920118,"Census Tract 9201.18, Los Angeles County, California",Census Tract 9201.18,1841,1696,145,623600
06037920119,"Census Tract 9201.19, Los Angeles County, California",Census Tract 9201.19,486,482,4,687500
06037920120,"Census Tract 9201.20, Los Angeles County, California",Census Tract 9201.20,1024,889,135,764400
06037920121,"Census Tract 9201.21, Los Angeles County, California",Census Tract 9201.21,3103,2315,788,669700
06037920200,"Census Tract 9202, Los Angeles County, California",Census Tract 9202,0,0,0,
06037920303,"Census Tract 9203.03, Los Angeles County, California",Census Tract 9203.03,626,294,332,842400
06037920312,"Census Tract 9203.12, Los Angeles County, California",Census Tract 9203.12,2232,1082,1150,753200
06037920313,"Census Tract 9203.13, Los Angeles County, California",Census Tract 9203.13,1551,1346,205,666400
06037920314,"Census Tract 9203.14, Los Angeles County, California",Census Tract 9203.14,1030,696,334,637000
06037920322,"Census Tract 9203.22, Los Angeles County, California",Census Tract 9203.22,981,801,180,633100
06037920326,"Census Tract 9203.26, Los Angeles County, California",Census Tract 9203.26,2233,1149,1084,753300
06037920328,"Census Tract 9203.28, Los Angeles County, California",Census Tract 9203.28,796,467,329,967900
06037920329,"Census Tract 9203.29, Los Angeles County, California",Census Tract 9203.29,2716,1568,1148,574000
06037920330,"Census Tract 9203.30, Los Angeles County, California",Census Tract 9203.30,1731,1120,611,626600
06037920331,"Census Tract 9203.31, Los Angeles County, California",Census Tract 9203.31,1240,929,311,584500
06037920332,"Census Tract 9203.32, Los Angeles County, California",Census Tract 9203.32,590,444,146,620000
06037920334,"Census Tract 9203.34, Los Angeles County, California",Census Tract 9203.34,2417,1567,850,513800
06037920338,"Census Tract 9203.38, Los Angeles County, California",Census Tract 9203.38,1696,1460,236,836500
06037920339,"Census Tract 9203.39, Los Angeles County, California",Census Tract 9203.39,2661,1708,953,926400
06037920340,"Census Tract 9203.40, Los Angeles County, California",Census Tract 9203.40,790,339,451,569300
06037920341,"Census Tract 9203.41, Los Angeles County, California",Census Tract 9203.41,818,62,756,540300
06037920342,"Census Tract 9203.42, Los Angeles County, California",Census Tract 9203.42,916,334,582,480800
06037920343,"Census Tract 9203.43, Los Angeles County, California",Census Tract 9203.43,1259,345,914,356000
06037930400,"Census Tract 9304, Los Angeles County, California",Census Tract 9304,354,290,64,487100
06037980001,"Census Tract 9800.01, Los Angeles County, California",Census Tract 9800.01,0,0,0,
06037980002,"Census Tract 9800.02, Los Angeles County, California",Census Tract 9800.02,0,0,0,
06037980003,"Census Tract 9800.03, Los Angeles County, California",Census Tract 9800.03,0,0,0,
06037980004,"Census Tract 9800.04, Los Angeles County, California",Census Tract 9800.04,0,0,0,
06037980005,"Census Tract 9800.05, Los Angeles County, California",Census Tract 9800.05,0,0,0,
06037980006,"Census Tract 9800.06, Los Angeles County, California",Census Tract 9800.06,0,0,0,
06037980007,"Census Tract 9800.07, Los Angeles County, California",Census Tract 9800.07,0,0,0,
06037980008,"Census Tract 9800.08, Los Angeles County, California",Census Tract 9800.08,33,0,33,
06037980009,"Census Tract 9800.09, Los Angeles County, California",Census Tract 9800.09,0,0,0,
06037980010,"Census Tract 9800.10, Los Angeles County, California",Census Tract 9800.10,56,13,43,
06037980011,"Census Tract 9800.11, Los Angeles County, California",Census Tract 9800.11,16,0,16,
06037980012,"Census Tract 9800.12, Los Angeles County, California",Census Tract 9800.12,0,0,0,
06037980013,"Census Tract 9800.13, Los Angeles County, California",Census Tract 9800.13,0,0,0,
06037980014,"Census Tract 9800.14, Los Angeles County, California",Census Tract 9800.14,10,0,10,
06037980015,"Census Tract 9800.15, Los Angeles County, California",Census Tract 9800.15,480,0,480,
06037980016,"Census Tract 9800.16, Los Angeles County, California",Census Tract 9800.16,88,2,86,
06037980017,"Census Tract 9800.17, Los Angeles County, California",Census Tract 9800.17,38,0,38,
06037980018,"Census Tract 9800.18, Los Angeles County, California",Census Tract 9800.18,0,0,0,
06037980019,"Census Tract 9800.19, Los Angeles County, California",Census Tract 9800.19,29,20,9,1041700
06037980020,"Census Tract 9800.20, Los Angeles County, California",Census Tract 9800.20,0,0,0,
06037980021,"Census Tract 9800.21, Los Angeles County, California",Census Tract 9800.21,13,13,0,
06037980022,"Census Tract 9800.22, Los Angeles County, California",Census Tract 9800.22,0,0,0,
06037980023,"Census Tract 9800.23, Los Angeles County, California",Census Tract 9800.23,0,0,0,
06037980024,"Census Tract 9800.24, Los Angeles County, California",Census Tract 9800.24,82,67,15,725000
06037980025,"Census Tract 9800.25, Los Angeles County, California",Census Tract 9800.25,223,0,223,
06037980026,"Census Tract 9800.26, Los Angeles County, California",Census Tract 9800.26,0,0,0,
06037980028,"Census Tract 9800.28, Los Angeles County, California",Census Tract 9800.28,0,0,0,
06037980030,"Census Tract 9800.30, Los Angeles County, California",Census Tract 9800.30,0,0,0,
06037980031,"Census Tract 9800.31, Los Angeles County, California",Census Tract 9800.31,10,0,10,
06037980033,"Census Tract 9800.33, Los Angeles County, California",Census Tract 9800.33,13,0,13,
06037980034,"Census Tract 9800.34, Los Angeles County, California",Census Tract 9800.34,9,0,9,
06037980035,"Census Tract 9800.35, Los Angeles County, California",Census Tract 9800.35,164,54,110,
06037980036,"Census Tract 9800.36, Los Angeles County, California",Census Tract 9800.36,106,51,55,
06037980037,"Census Tract 9800.37, Los Angeles County, California",Census Tract 9800.37,0,0,0,
06037980038,"Census Tract 9800.38, Los Angeles County, California",Census Tract 9800.38,0,0,0,
06037980039,"Census Tract 9800.39, Los Angeles County, California",Census Tract 9800.39,0,0,0,
06037990100,"Census Tract 9901, Los Angeles County, California",Census Tract 9901,0,0,0,
06037990200,"Census Tract 9902, Los Angeles County, California",Census Tract 9902,0,0,0,
06037990300,"Census Tract 9903, Los Angeles County, California",Census Tract 9903,0,0,0,